Administrator of the Environmental Protection Agency|EPA Administrator|Environmental Protection Agency Administrator
Arizona Attorney General|Attorney General|Arizona
Assistant Secretary of State for European and Eurasian Affairs|Assistant Secretary of State for European Affairs
Assistant Secretary of State for International Organization Affairs|International Conference
Attorney General for the District of Columbia|D.C. Attorney General
Attorney General of California|State Attorney General|California attorney general's office|Attorney General|California attorney general|attorney general|California Attorney General
Attorney General of Kentucky|Attorney General|Kentucky Attorney General|Kentucky attorney general|attorney general
Attorney General of Maryland|Maryland Attorney General|Attorney General|Maryland's attorney general
Attorney General of New York|New York attorney general|NY Attorney General|New York Attorney General|New York's Attorney General|attorney general
Attorney General of Oklahoma|Attorney General|Oklahoma Attorney General|Oklahoma's attorney general
Attorney General of Virginia|Virginia attorney general|Attorney General|Virginia's Attorney General|Virginia|Virginia Attorney General
Attorney-General for Australia|Former Attorney General|Attorney General's office
Black Rod
California Insurance Commissioner|Insurance Commissioner
Chair of the Federal Reserve|Federal Reserve Chairman|Fed Chair|Chair
Chairman of the Joint Chiefs of Staff|The chairman of the Joint Chiefs of Staff|Chairman
Chancellor of Germany (1949â€“present)|Chancellor
Chancellor of Germany|German Chancellor
Chief Cabinet Secretary
Chief Executive (Afghanistan)|Chief Executive
Chief Executive of Hong Kong|Chief Executive
Chief Financial Officer of Florida|Florida Chief Financial Officer
Chief Justice of the United States|U.S. Supreme Court chief justice
Chief of Naval Staff (Pakistan)|Navy commander
Chief of the Los Angeles Police Department|Los Angeles Police Chief|LAPD Chief|Los Angeles police Chief
Colorado Attorney General|Colorado attorney general
Commissioner of Baseball|Baseball Commissioner|Commissioner
Commissioner of Food and Drugs|FDA Commissioner
Commissioner of the NBA|NBA Commissioner|NBA commissioner|Commissioner
Comptroller of Maryland|comptroller|Maryland Comptroller|Comptroller
County Executive of Cuyahoga County, Ohio|Cuyahoga County Executive
Crown Prince of Saudi Arabia|Saudi Arabia's Crown Prince|Saudi Crown Prince|Saudi crown prince
Dalai Lama
Deputy Director of the Central Intelligence Agency|Deputy
Director of National Intelligence|ODNI|Intelligence|director of national intelligence|Office of the Director of National Intelligence
Director of the Central Intelligence Agency|CIA Director
Director of the Federal Bureau of Investigation|FBI Director
European Data Protection Supervisor|EDPS
Federal Council (Switzerland)|Swiss government
First Lady of the United States|First Gentleman|First Lady
First Lady or First Gentleman of the Philippines|Former First Lady
Florida Attorney General|Florida's attorney general|Florida attorney general|Florida Attorney General's Office|Florida's Attorney General
Florida Commissioner of Agriculture|Florida's Agriculture Commissioner|Agriculture Commissioner
Governor of California|California's governor|California governor|Gov.|California|Calif|Governor's office|Gov|Governor's Office|CA|California Governor
Governor of Colorado|Gov.|Governor
Governor of Illinois|Gov.|Illinois Gov|Illinois
Governor of Indiana|Gov.|Indiana governor
Governor of Iowa|Gov.|Iowa governor
Governor of Kentucky|governor|Kentucky governor|Gov.|Kentucky Governor|Governor|KY|Kentucky
Governor of Maryland|Governors of Maryland|The governors of Maryland|Gov.|Md|Maryland's Governor|Gov|Maryland|Maryland Governor|Maryland governor
Governor of Massachusetts|Gov.|Massachusetts Governor|Massachusetts governor
Governor of Michigan|Gov.|Governor|Michigan governor|Michigan
Governor of Minnesota|Gov.|Governor|Minnesota|Minnesota governor
Governor of New Jersey|Gov.|Governors|NJ Gov|New Jersey governor
Governor of New York|governor|New York|Gov.|Governor|New York governor|Gov
Governor of North Carolina|Gov.|Governor|North Carolina Governor
Governor of Oklahoma|Oklahoma governor|Oklahoma Gov|Okla
Governor of South Carolina|Gov.|South Carolina Governor|South Carolina governor
Governor of Tennessee|Tennessee governor|Gov.|Tennessee Governor
Governor of Texas|Gov.|Texas Gov|Texas Governor|Texas governor
Governor of Vermont|Gov.
Governor of Virginia|governor|Gov.|Virginia|Governor|Virginia Governor
Governor of Wisconsin|Gov.|Wisconsin governor
Illinois Attorney General|Illinois attorney general
Illinois Comptroller|Illinois State Comptroller
King County Executive
Lieutenant Governor of California|Lt. Governor
Lieutenant Governor of Georgia
Lieutenant Governor of Maryland|Lieutenant Governor
Lieutenant Governor of New York
Lieutenant Governor of Texas|Lt. Gov
Maine State Treasurer|Treasurer
Mayor of Austin|Mayor
Mayor of Bristol|Bristol mayor
Mayor of Chicago|Chicago mayors|Chicago Mayor|Chicago's Mayor|Chicago's mayor|mayor|Chicago mayor|Chicago|CHICAGO|Mayor
Mayor of Dallas|Dallas mayor|mayor of Dallas|Dallas Mayor|Mayor
Mayor of Jersey City, New Jersey|Jersey City Mayor
Mayor of Los Angeles|Los Angeles Mayor|Los Angeles|Mayor
Mayor of Miami Beach, Florida|mayor of Miami Beach|Mayor
Mayor of New York City|New York City Mayor|New York mayor|New York Mayor|NYC Mayor|Mayor's Office
Mayor of San Francisco|SF Mayor|San Francisco Mayor|San Francisco mayor|Mayor
Mayor of San Jose|San Jose Mayor
Mayor of Seattle|Seattle Mayor
Mayor of St. Louis|St. Louis Mayor
Mayor of Venice|Mayor
Mayor of the District of Columbia|D.C. Mayor|DC Mayor|Mayor
Michigan Attorney General|Michigan's Attorney General's Office|State Attorney General|Attorney General's Office|Attorney General|Michigan Attorney General's Office|attorney general
Minister of Arts and Culture|ARTS & CULTURE|Arts and Culture
Minister of Foreign Affairs (Russia)|Foreign Minister of Russia|Russian Foreign Minister
Minister of Foreign Affairs (Turkey)|Turkish Foreign Minister
Minister of Health (Malaysia)|health minister
New York City Police Commissioner|NYPD Commissioner|NYC Police Commissioner|New York City police commissioner|Commissioner
New York City Public Advocate|Public Advocate
New York County District Attorney|Manhattan District Attorney's office|Manhattan district attorney|Manhattan District Attorney's Office|Manhattan District Attorney|Manhattan district attorney's office
New York State Comptroller
North Carolina Attorney General
Ohio Attorney General|Attorney General|Ohio attorney general
Ohio State Auditor|Ohio Auditor
Presidency of the Council of the European Union|European Union Presidency
President of Afghanistan|Afghan President
President of Argentina|Argentine President
President of Bolivia|Bolivian President|Bolivian president|President
President of Brazil|Brazilian President|Brazilian president|Brazil's President
President of Chile|Chilean President|Chile's president|Chile's President
President of France|France's president|French President|French president
President of Honduras|Honduran president
President of Indonesia
President of Iran|Iranian President|Iran's president
President of Italy|Italian President
President of Lebanon|Lebanese President
President of Mexico|Mexico's president|Mexican president|Mexico's President
President of Nigeria|President and Commander-in-Chief
President of Russia|Russian president|Russia's President|Russian President
President of Sri Lanka|Sri Lanka's president
President of Syria|Syria's President|Syrian President
President of Turkey|Turkish president|Turkey's president|Turkey's President|Turkish President
President of the European Commission|European Commission President
President of the European Council|European Council President
President of the Los Angeles City Council|Los Angeles City Council President
President of the People's Republic of China|China's President|Chinese President|Chinese president
President of the United Nations General Assembly|president of|President Of
President of the United States|then-President|United States President|U.S. President|US president
Prime Minister of Bulgaria|Bulgarian prime minister
Prime Minister of Canada|Canadian prime minister|Canadian Prime Minister|Canadian PM
Prime Minister of Ethiopia|Ethiopian Prime Minister|Prime Minister
Prime Minister of France|French Prime Minister
Prime Minister of India|India's Prime Minister
Prime Minister of Iraq|Iraqi Prime Minister|Iraqi prime minister|Iraq's prime minister
Prime Minister of Israel|Israel's Prime Minister|Israeli Prime Minister
Prime Minister of Italy|Italy's prime minister
Prime Minister of Japan|Japan's Prime Minister|Japan's PM|Japanese Prime Minister
Prime Minister of Lebanon|Lebanese Prime Minister
Prime Minister of Pakistan|Pakistan Prime Minister
Prime Minister of Poland|Polish Prime Minister
Second Lady of the United States|Second Lady
Secretary for Innovation and Technology|Innovation and Technology
Secretary for Security
Secretary of State for Foreign and Commonwealth Affairs|Foreign Secretary
Secretary of State for Health and Social Care|Health Secretary|health secretary
Secretary of State for Transport|DTLR
Secretary of State of Arizona|Secretary of State|Arizona secretary of state
Secretary of State of Arkansas|Secretary of State
Secretary of State of California|California Secretary of State
Secretary of State of Colorado|Secretary of State|Colorado Secretary of State
Secretary of State of Florida|Florida Secretary of State|Secretary of State
Secretary of State of Kentucky|Secretary of State|Kentucky Secretary of State|Kentucky secretary of state
Sheriff of Clark County|Clark County Sheriff
Speaker of the House of Commons (United Kingdom)|House of Commons Speaker|Speaker of the House
Speaker of the Texas House of Representatives|House Speaker|Texas House speaker|Speaker|Texas House Speaker
Speaker of the United States House of Representatives|Speaker|House|House Speaker|U.S. House Speaker|Speaker of the House
State President of South Africa|State President|President's Council
Texas Attorney General|Texas AG|Texas attorney general's office|Texas Attorney General's Office
Texas Comptroller of Public Accounts|Texas Comptroller
United States Ambassador to the European Union|US Ambassador to the European Union|United States ambassador to the European Union|U.S. ambassador to the European Union|EU|US ambassador to the EU|U.S. Ambassador to the European Union|US Ambassador to the EU|Ambassador to the European Union
United States Ambassador to the United Nations|U.S. Ambassador to the UN|US ambassador to the UN|UN|US Ambassador to the United Nations|Ambassador to the UN|US Ambassador|U.S. Ambassador to the United Nations|UN Ambassador|Ambassador to the United Nations|United Nations|U.S. ambassador to the United Nations|US Ambassador to the UN|U.S. Ambassador|US ambassador to the United Nations|US ambassador|U.N. Ambassador|United Nations Ambassador
United States Permanent Representative to NATO|US ambassador to NATO
United States Secretary of Defense|U.S. Secretary of Defense|Defense Secretary|U.S. Defense Secretary|Secretary|defense|US Defense Secretary|US Secretary of Defense|defense secretary|Secretary of Defense|Defense
United States Secretary of the Air Force|Air Force Secretary
United States Secretary of the Army|Army Secretary
United States Secretary of the Navy|Secretary of the Navy|U.S. Navy Secretary|Navy Secretary
Vice Chairman of the Joint Chiefs of Staff
Vice President of the United States|U.S. Vice President|Vice President
Virginia Secretary of Finance|Secretary of Finance
Westchester County Executive|County Executive
White House Chief of Staff|Chief of Staff|White House chief of staff
