Aboriginal Australians
Acadians|Acadian
African Americans|African-American|Black|Colored People|Negroes|African-Americans|colored people
Afro-Caribbean
Ainu people|Ainu
Albanians|Albanian heritage
American Jews|American-Jewish|Jews in the United States|Jewish Americans
American immigration to Mexico|Americans in Mexico
Americans in the United Kingdom|American-British
Americans|American people
Armenian Americans|Armenian American
Armenians|Armenian people
Asian Americans|Asian American|AAPI|Asian-American
Assyrian Americans|Assyrian American
Assyrian people|Assyrians
Asylum seeker|Asylum-seekers
Baghdadi Jews|Baghdadi
Banjara|Lambani
Bilen people|BOGOs
Bosniaks|Bosnian Muslim
British Jews
Cajuns|Cajun
Catalans
Catawba people|Catawba Indian Nation|Catawba Nation|Nations|Catawba Reservation
Chechens|Chechen
Cherokee
Cheyenne|Cheyennes
Chickasaw
Chinese Indonesians|Chinese-owned
Chinese people in Sweden|Chinese-Swedish
Citizen Potawatomi Nation
Coushatta Tribe of Louisiana
Cuban Americans|Cuban-American
Czechs|Czech people
Ecuadorians|Ecuadoran
Filipino immigration to Mexico|Filipino-Mexican
French Americans|French-American
French Canadians|French Canadian
French Mexicans|French-Mexican
German Americans|German immigrants|German immigrant
Greek Americans|Greek-American
Guajajara
Haitians|Haitian people
Havasupai
Hispanic and Latino Americans|Latino community|Hispanic or Latino|Latino Community|Hispanic and Latino|Hispanic community
Indian Americans|Indian-Americans
Indigenous Australians|Australians|Aboriginal
Indigenous peoples of Mexico|Mexican-Indian
Indigenous peoples of the Americas|INDIGENOUS|American Indian|Native Americans|Indigenous
Iranian Americans|Iranian American
Irish people|Irishman
Israeli Americans|Israeli-American
Israelis|Israeli-Palestinian|Israeli
Italian Americans|Italian-Americans|Italian|Italo-American|Italian-American|Italian immigrants|American
Italians|Italian people|Italian painter
Japantown|Japanese town
Jews|Jew|Jewish
Kashmiris
Koreans in Japan|Japanese-born
Kurdish Americans|Kurdish-American
Kurds in Syria|Syrian Kurdish|Syrian Kurd|Syria's Kurds|Syrian Kurds
Kurds in Turkey|Turkish Kurds
Kurds|the Kurds|Kurdish people|KURDS|Kurdish community|Kurd
Lakota people|Dakota|Lakota
Lebanese Americans|Lebanese-American
Leech Lake Band of Ojibwe
Lenape|Native Americans
Lummi|Lummi Nations|Lummi nations
Makah|Makah Indian Tribe|Makah Tribe
Match-e-be-nash-she-wish Band of Pottawatomi Indians of Michigan|Gun Lake Tribe
Mexican Americans|Mexican origin|Mexican descent|Mexican American|Mexican-American
Mohegan
Movere
Muscogee (Creek) Nation
Native Hawaiians|Native Hawaiian
Navajo
Ohlone
Ojibwe
Okie
Oneida people|Oneida Nation
Oromo people|Oromos
Overseas Chinese|Chinese immigrant
Overseas Vietnamese|Vietnamese community
Palestinians|Palestinian
Pamunkey|Pamunkey Tribe
Pennsylvania Dutch|Penn Dutch
Polish Americans|Polish immigrants
Potawatomi
Puerto Ricans|People of Puerto Rico|Boricua
Quinault Indian Nation
Ramapough Mountain Indians|Ramapough Lenape Nation
Refugee|Muslim refugees
Rohingya people|Rohingya Muslim|Rohingya
Russians
Sakonnet
Sekani
Seminole Tribe of Florida
Seminole|Seminoles|Seminole Tribe
Sephardi Jews|Sephardic Jew
Shawnee|SHAWNEE
Snoqualmie Indian Tribe|Snoqualmie|Snoqualmie Tribe
Spaniards|Spaniard
Syrian Jews
Syrian Turkmen|Turkish-Syrian
Syrians|Syrian|Syrian Arab
Tequesta|TEQUESTA
Tonkawa
Turkish Americans|Turkish-American
Ukrainian Americans|Ukrainian-American
Ukrainians|Ukrainian people
Uyghurs|Uighur|Uighurs
Vietnamese Americans|Vietnamese-American|Vietnamese refugees
Votes
Wampanoag|Wampanoags
White Americans|American white|White American
Wiyot Tribe
Yakama
