3M22 Zircon|Zircon
46th Annual Grammy Awards|2004 Grammy
50th Annual Country Music Association Awards|50th Annual
78th Academy Awards|Awards Ceremony
9K32 Strela-2
ABA League Top Prospect|Top Prospect
AGM-78 Standard ARM|Starms
AK-47|AK-47s
AT&T ESPN All-America Player|Player of the Week
Academy Award for Best Actress|Actress
Academy Award for Best Picture|Best Picture|best picture
Academy of Country Music Awards|Country Music Awards
Alabama Senate|Alabama's Senate|Senate
Alaska House of Representatives|State rep|State Rep|State Reps|Rep.
American Athletic Conference Men's Basketball Player of the Year|Player of the Year|AAC POY
American Sign Language
Arizona Senate|Senate
Arkansas House of Representatives|Arkansas State Representative
Arkansas Senate|Arkansas Senator|Arkansas State Senator
Associated Press NFL Most Valuable Player Award|MVP
Associated Press NFL Offensive Player of the Year Award|offensive player of the year|Awards|Offensive Player of the Year
Associated Press NFL Rookie of the Year Award|Offensive Rookie of the Year
Atlantic Coast Conference Men's Basketball Player of the Year|ACC Player of the Year
Bakersfield sound
Baltimore City Council|Baltimore City|City Council
Bangladesh–India relations|India and Bangladesh|Bangladesh and India
Bangor City Council
Best Driver ESPY Award|Best Driver
Big Ten Conference Men's Basketball Player of the Year|Big Ten Player of the Year
Board of Aldermen of the City of St. Louis|Board of Aldermen|St. Louis Board of Aldermen|Alderman|St. Louis Board Of Aldermen
Bob Cousy Award
Booker Prize|Booker|Man Booker
Bradley Fighting Vehicle
Brazilian Portuguese|Brazilian Portugese
Breakthrough Brits
Breakthrough Prize
Breton language|Breton
Brighton and Hove City Council|Brighton City Council
Britannia Awards|Britannia Award
Bronze Star Medal|Bronze Star
Browning X-Bolt|Browning X-bolt|X-Bolt
Broyles Award
Burlsworth Trophy
Caldecott Medal
California English|English
California State Assembly|California Assembly|Assemblyman|California Assemblyman
California State Legislature|California Legislature|Senate|Legislature
California State Senate|California Senator|California senator
Canadian French
Cantonese
Catalan language|Catalan
Central Commission for Discipline Inspection|Review Committee
Charlotte City Council|city council|City council|Charlotte city council
Chicago City Council|Aldermen|City Council
Chicago house|Chicago House Music
China–United States relations|U.S.-China Relations|U.S.-China|US-China|United States and China|China and the United States|U.S-China
Christian hip hop|Christian rapper
Cincinnati City Council|Cincinnati City Councilman
City of York Council|York City Council
Cleveland City Council|City Council
College Football All-America Team|AP All-America|All-America team|All-American team|AP
Colorado General Assembly|General Assembly|Colorado Legislature
Connecticut General Assembly|Connecticut legislature
Connecticut House of Representatives|State Rep
Connecticut Senate
Contemporary Christian music|Christian recording artist
Contemporary R&B|R&B
Cortes Generales|Spain's parliament|Spanish court
Council of the District of Columbia|D.C. Councilmember|Council|D.C. Council|Councilman|councilman
Council of the European Union|council|Council
Country Music Association Awards|2009 CMA Awards|CMA|CMAs|CMA Awards|CMA Award|Country Music Awards|Entertainer of the Year|entertainer of the year
Country music|Country|Country Music|country music|The Country Music|Country Singer|Country Music Song|country
Country pop|Country-pop|Pop-country
Critics' Choice Movie Awards|Critics' Choice|Critics Choice
Croatian Parliament|Sabor
Cy Young Award|AL Cy Young Award|American League Cy Young Award|NL Cy Young|AL Cy Young|Cy Young awards|National League Cy Young Award|NL Cy Young Award|Cy Young Awards|Cy Young
Davey O'Brien Award|Davey O'Brien National Quarterback Award
Detroit City Council|City Council
Detroit blues|Detroit-based
Dezhou braised chicken|Braised Chicken
Disco
Distinguished Flying Cross (United Kingdom)|DFCS
Distinguished Flying Cross (United States)|Distinguished Flying Cross
ESPY Award|ESPY
Egypt–United States relations|U.S.-backed
Emmy Award|Emmy-nominated|Emmy Awards|Emmy-winning|Emmy Award-winning|Emmys|Emmy
English language|English version|English teacher|En|English equivalent|English Language
European Champion Clubs' Cup|Earned the Right
European Film Awards
European Parliament
Exocet
First Win|first win
Florida House of Representatives|Florida House|House|The Florida House
Florida Legislature|Legislature
Florida Senate|Florida's Senate|Florida State Senate|Florida's state Senate|Senate
Fred Biletnikoff Award|Biletnikoff Award
Freedom Award|Freedom Awards
Funk
G-funk|West Coast G-funk
GMA Dove Award|Dove Awards|GMA
Georgia House of Representatives|Georgia House|Georgia's house
Glamour Awards|Woman of the Year
Glock
Go-go|Go-Go
Golden Joystick Awards
Golden Lion
Gospel music|Gospel Singer|Gospel Artist|Gospel|gospel singer
Governors Awards
Guardian Council
Hard rock|Hard Rock
Hardcore punk|Hardcore
Hart Memorial Trophy|Hart|Hart Trophy
Hawaiian language|Hawaiian
Heart & Hustle Award|Heart & Hustle
Hebrew language|Hebrew
Heisman Trophy|Heisman-winning|Heisman Trophies|Heisman
Hermann Trophy|MAC Hermann Trophy
High German languages|High German
Highlife|Hi-Life
Hindi
Hip hop music|Hip-hop
Hollywood Film Award for Best Actor|Hollywood Actor Award
Hollywood Film Awards
House music|UK's House
House of Commons of the United Kingdom|House of Commons|British House of Commons|Commons|Parliamentary
House of Lords
House of Representatives of the Philippines|House Speaker
Humvee|Humvees
Illinois General Assembly|Illinois legislature|House|General Assembly
Illinois House of Representatives|Illinois state House of Representatives|House|Illinois House
Illinois Senate|The Illinois Senate|State Senator
Independent Spirit Awards|Spirit Awards
Indian Telly Award for Best Reality Show|Best Reality Show
Indiana General Assembly
Indiana House of Representatives|Indiana's House
Indianapolis City-County Council|City-County Council
India–Pakistan relations|India and Pakistan
Iowa Senate
Iron Dome
J-pop|Japanese pop
James Norris Memorial Trophy|Norris Trophy
Japanese language|Japanese
Japan–United States relations|United States and Japan
Jazz|jazz
K-pop|k-pop|Fans|K-Pop|Korean pop|South Korean pop
Kansas Senate
Karl Malone Award
Kentucky General Assembly|General Assembly
Kentucky House of Representatives|Kentucky State Representative|Kentucky's House
Kentucky Senate|Senate
Kerrigan v. Commissioner of Public Health|Beth Kerrigan
King County Council
Kir Royal|Kir Royale
Korean dialects|Southern Korean
Larry O'Brien Championship Trophy|Larry O'Brien Trophy
Latin American Music Award|Latin AMAs|Latin American Music Awards
Latin Grammy Award|Latin GRAMMY|Latin Grammy Awards|Latin GRAMMYs|Latin GRAMMY Awards|Awards|Latin Grammys
Latin Recording Academy Person of the Year|Person of the Year
Latin music|Latin-music
Latin
Laurence Olivier Award for Best New Play|Play Of The Year
League Championship Series Most Valuable Player Award|NLCS MVP|MVP
Legislative Council of Hong Kong|Hong Kong's Legislative Council
Los Angeles City Council|LA City Council|Los Angeles City|City Council
Los Angeles County Board of Supervisors
Loudoun County Board of Supervisors
Louisiana Creole|New Orleans Creole
Louisiana House of Representatives|Louisiana House|House of Representatives
Louisiana State Legislature|Louisiana state|Louisiana state Senate
Louisiana State Senate|Louisiana Senate
Louisville Metro Council|Metro Council
M16 rifle|AR-15s
M18 recoilless rifle|M18
M4 carbine|M4
MTV Europe Music Award|MTV Europe Music Awards|MTV EMAs|MTV EMA|EMA|MTV European Music Awards|Europe Music Awards
Maine House of Representatives|Maine State Representative|Maine house
Maine Legislature|Legislature
Maine Senate|Maine state Senator
Major League Baseball Comeback Player of the Year Award|NL Comeback Player of the Year
Major League Baseball Most Valuable Player Award|Most Valuable Player|MVPs|American League MVP|MVP Awards|MVP|American League MVP Award|AL MVP|NL MVP|National League MVP
Major League Baseball Rookie of the Year Award|American League Rookie of the Year|NL Rookie Of The Year Award|Rookies of the Year|AL|AL Rookie of the Year|American League Rookie of the Year Award|Major League Baseball|AL Rookie of the Year Award|NL Rookie of the Year|AL ROY|National League Rookie of the Year|Rookie of the Year
Make-Up Artists and Hair Stylists Guild|Make-Up Artists & Hair Stylists Guild Awards
Malcolm Baldrige National Quality Award
Maricopa County Board of Supervisors
Mark Twain Prize for American Humor
Maryland General Assembly|General Assembly|State|state
Maryland House of Delegates|State Delegate|Maryland State Delegate|Maryland Delegate
Maryland Senate|State Senator|Maryland's Senate|Senate
Massachusetts General Court|General Court|Legislature
Massachusetts House of Representatives|Massachusetts House|Massachusetts house
Maxwell Award
Medal of Heroism (Czech Republic)|Medal of Heroism
Medal of Honor
Metalcore|metalcore
Mexican pop music|Mexican pop
Michigan House of Representatives|House|Michigan's House|Michigan House|State Representatives|Michigan representative
Michigan Legislature|Legislature
Michigan Senate|Senate
Minneapolis City Council|Minneapolis city
Minnesota House of Representatives|MN House
Minnesota Legislature
Minnesota Senate|Minnesota State Senator|Minnesota senator|Minnesota Senator
Missouri House of Representatives|Missouri House|House of Representatives
Montana Senate|Senate
NFL Honors|Salute to Service Award
Naismith College Player of the Year|Naismith Player of the Year
National Film Awards|national
National Football League Coach of the Year Award|NFL's Coach of the Year|NFL Coach of the Year
New Jersey General Assembly|Assemblyman|New Jersey house
New Jersey Legislature|Legislature
New Jersey Senate|New Jersey senator|New Jersey Senator
New Orleans City Council
New York City Council|Council|New York City Councilman|New York City Council Member|Councilman|City Council Speaker|councilman|New York's City Council|NYC Council|City Council
New York State Assembly|State Assemblyman|Assemblyman|Assemblywoman|New York state assemblyman|Assembly|Assembly District
New York State Legislature|Legislature
New York State Senate|Senate
New Zealand English|Maori
New wave music|New Wave
Newport City Council|City Council
Nobel Memorial Prize in Economic Sciences|Nobel Prize In Economics|Nobel Economics Prize
Nobel Peace Prize|peace|Nobel Peace
Nobel Prize in Literature|Nobel Prize for Literature
Nobel Prize|Nobel Prizes|Nobel
Nopalito|Nopalitos
Nordic Council Environment Prize
North Carolina General Assembly|General Assembly|North Carolina Legislature|NC General Assembly
North Carolina Senate|NC Senate|Senate|The North Carolina Senate
North Korea–South Korea relations|inter-Korean
O. J. Simpson murder case|Murder Trial|murder trial|Murder Case
Ohio General Assembly|Ohio legislature|Legislature
Ohio House of Representatives|District 80|Ohio house|Ohio House
Ohio Senate|State Senator|Ohio State Senator
Oklahoma House of Representatives|Oklahoma State Representative|House|Oklahoma House
Oklahoma Legislature|Legislature
Oklahoma Senate|Oklahoma Senator
Orange Whip
Palme d'Or|Palme
Panelle
Parliament of England|British Parliament
Parliament of the United Kingdom|Parliament|British parliament|U.K. Parliament|MPs|Houses of Parliament|UK Parliament|UK parliament|Britain's Parliament|British
Paul Hornung Award
Pennsylvania General Assembly|Assembly|Legislature
Pennsylvania State Senate|State Senator|Pennsylvania State Senator|Pennsylvania state Senate|Pennsylvania State Senators
People v. Turner|Brock Turner
Philadelphia City Council|Council|City Council
Plurinational Legislative Assembly|Senate
Polka
Pop music|Pop Festival|Pop.
Portuguese language|The Port
Presidential Medal of Freedom|Medal of Freedom
Presidents' Trophy
Prix Goncourt
Pulitzer Prize|Pulitzer|Pulitzer Prize-winning
Purple Heart
Reggaeton
Rhumba|Rumba
Rhythm and blues|R & B|R&B soul|R&B
Riot grrrl|Riot-grrrl
Roberto Clemente Award
Rock and roll|Rock-and-roll
Rock music|Rock Bands|Rock|The Rock
Roe v. Wade
Russian language|Russian
Russia–Ukraine relations|Russia and Ukraine
S-400 missile system|S-400
Saint Paul City Council|St. Paul City Council
San Francisco Board of Supervisors|San Francisco Supervisor|Board of Supervisors|San Francisco supervisor|Supervisor|Supervisors
San Jose City Council
Saturn Award for Best Costume Design|Best Costume
Scots language|The Scots
Screen Actors Guild Life Achievement Award|Life Achievement Award
Seattle City Council|Council|Seattle's City Council
Senate of Spain|Senate Seat
Senate of Virginia|Virginia State Senate|Virginia's state Senate|Virginia's Senate|Virginia|Virginia Senate|Senator|Senate
Senate of the Philippines|Senate President
Shona language|Shona
Silver Star
Slam Dunk Contest|Slam Dunk
Soldier's Medal|Soldier's Medals
Soul music|Soul
South Carolina General Assembly|South Carolina's legislature
South Carolina House of Representatives|SC House
Southern rock
Spanish language|Spanish-language|Spanish word|Spanish-Speaking|Spanish club
Spotlight Awards
Stanley Cup|Stanley Cup Final|Stanley Cups|Stanley Cup champions|Cup
Sun Kudumbam Viruthugal for Best Brother|Best Brother
Swahili language|Swahili
Syrian Democratic Council
Tagalog language|Tagalog
Tamil language
Tampa City Council
Tasting menu|Tasting Menu
Tataki
Tennessee House of Representatives|TN House
Tennessee Senate|State Senate|Tennessee's state Senate
Texas House of Representatives|Texas House
Texas Legislature
Texas Senate|Senate
Texas country music|Texas Country
Tony Award for Best Play|best play|Best Play
Tony Award|Tony-winning|Tony-award|Tony Award-winning|Tony
Ukrainian language|Ukranian
United Kingdom–United States relations|US and UK
United States Congress|U.S. Congressmen|Congressional|Congress|U.S. Congress|Legislature|Congressman|US Congress|congressional|Capitol Hill
United States House Committee on Rules|House Rules Committee|Rules committee|Rules Committee
United States House of Representatives|Members of Congress|House|house|US House|Congress|U.S. House|U. S. Representative|House of Representatives|U.S. Rep|congressman|Rep.|Congressional|U.S. Reps|Congressmen|U.S. Congressman|Congressman|Representative|U.S. Representative|congresswoman|The U.S. House of Representatives|Representatives|Congresswoman|U.S. House of Representatives|congressional
United States Senate|S|U.S. Senator|Sen|US Senator|senators|Senator|United States Senator|United States senator|US senators|U.S. Senators|senator|Senate leaders|U.S. Sen|Sen.|United States|senate|US Senate|Sens|Senate candidates|Senators|U.S. Senate|American|Senate
Urdu
Vince Lombardi Trophy|Lombardi Trophy
Virginia General Assembly|Virginia legislature|General Assembly
Virginia House of Delegates|Delegate|House of Delegates|Virginia House|House|Delegates
Walter Camp Man of the Year
Washington State Legislature|Washington state Legislature|Legislature
Web Cartoonists' Choice Awards|Choice Awards
Webb Ellis Cup
West Coast hip hop|West Coast-based
Whatcom County Council|Charles Weimer
Wildlife Photographer of the Year
William V. Campbell Trophy|Campbell Trophy
Wisconsin Legislature|Wisconsin's Legislature|Legislature
Wizard rock|Wizard Rock
World Series Most Valuable Player Award|Most Valuable Player|World Series MVP|MVP|MVP of the World Series|World Series' Most Valuable Player Award
Wyoming Senate|Senate
Zydeco|zydeco
