1955 Pulitzer Prize
1969 American Football League playoffs|third quarter|First Quarter|Second Quarter|Third-quarter|fourth quarter|Fourth-quarter|Fourth Quarter|Third Quarter
1970s in music|70s
1980 Pulitzer Prize
1980s in music|80s
1990s in music|90|the '90s|90s
1994 Pulitzer Prize
2D computer graphics|2D
300 win club|300th Career Win|300 Wins
3D computer graphics|3D
3rd Grey Cup|14 to 7
A la carte pay television|Skinny Bundle
A major|3s
ANSI escape code|SCROLL DOWN
AWK|Awk
Abdomen|Abdominal
Abdominal aortic aneurysm|AAA
Abuse|Mistreatment
Açaí na tigela|acai bowls
Accident|Accidentally
Accuracy and precision|Accuracy
Achilles tendon|Achilles
Acid throwing|Acid Attack
Acromioclavicular joint|AC Joint|AC
Action film|Action-thriller
Activated carbon|activated charcoal
Active duty|active duty military
Active shooter|active shooter|Active Shooter|Active-shooter
Activity centre|Activity Center
Acute myeloid leukemia|Acute Myeloid Leukemia
Addition|Adding
Adipose tissue|belly fat|Belly Fat
Adjustment disorder|Closed In
Administrative court|Adm.
Administrative law|Administrative Rules
Adolescence|Teen Girl|Teenage
Adult education|JOB TRAINING|Job Training
Adverbial clause|As soon as
Advertising campaign|PR campaign
Advertising|Ad|Advertised
Advisory board|Advisory Board|Advisory Group
Advocacy group
Aerial photography|Aerial Photography|Aerial Imaging
Affordable housing|Affordable Housing|affordable housing
African swine fever virus|African swine fever
Afterburner|reheat|Reheat
Afton Oaks, Houston|Afton Oaks
Ageing|20-Somethings
Ageism|Ageist
Aggravated sexual assault|Aggravated Sexual Assault
Agricultural education|Agricultural Education
Agricultural experiment station|Agricultural Experiment Station
Agricultural show|Show|Agricultural Fair
Agriculture|agricultural products
Ahistoricism|Historically Inaccurate
Air conditioning|Air
Air pollution|Air Pollution|air quality|air pollution|Air|Air Quality
Air quality index|AQI|Air Quality Index
Air traffic control|Air Traffic Control
Air-cooled engine|Air-Cooled
Airbag|Air Bags
Aircraft carrier|Aircraft
Airline|commercial airlines
Airport security|airport security|Airport Security
Airway (aviation)|Flight Path|flight path
Al-Qahtaniyah, al-Hasakah Governorate|Qahtaniyah|al Qahtaniyah
Al-Qurayshi|al-Qurayshi
Alanine|D-Ala
Alarm clock|snooze button
Album|Album Title
Alcohol by volume|ABV
Alcoholic drink|Alcohol Beverage
Algae|Algal
All-inclusive resort|all-inclusive|All-inclusive
All-terrain vehicle|ATV|ATVs
Allergy|Allergic|Allergic Reaction|Allergist
Alligator|Gator
Almond Roca
Almond biscuit|Almond Cookies
Alprazolam|Xanax
Alternate history|New Timeline
Alternate route|Alternate Route
Ambassador|Amb.
Ambulance|Ambulance Service
Amen
American football positions|Special Teams|OFFENSE|special teams
American football rules|Forward Progress
American football strategy|Run defense|Pass-defense
Amusement park|amusement park|Theme Parks|Amusement Park|Theme Park|theme parks|Amusement
Amusia|Tone Deaf
Amyotrophic lateral sclerosis|ALS|Lou|Lou Gehrig
Anal cancer|anal cancer
Analog television|V-Sync
Analysis paralysis|Thinking Too Much
Ancient history|Ancient World|ancient world
And More
Android version history|Face Unlock
Angel food cake|Angel Food Cake|angel food cake
Anger|Ticked Off
Animal bite|Animal Bites
Animal rescue group|Rescue group|animal rescue|Animal Rescue|Dog rescue
Animal rights|Animal Rights Activists|Animal Rights|animal rights
Animal shelter|Animal Shelter|Dog Shelters|animal shelter
Animal welfare|Animal Welfare|Animal Care Services|Animal Care|animal welfare
Animal|Animal Services
Animal-assisted therapy|Pet Therapy
Animation|Cartoon|Animated Movies
Anniversary|Tricentennial
Anorexia (symptom)|loss of appetite
Anterior cruciate ligament injury|ACL
Anterior cruciate ligament|ACL
Anterior fornix erogenous zone|A Spot
Anti-Americanism|anti-American
Anti-nuclear movement|Anti-nuclear
Antimicrobial resistance|Superbugs
Antisemitism|anti-Semitism|anti-Semitic|Anti-Semitic
Antivirus software|Virus Scanner|virus scanner
Anxiety disorder|Anxiety Disorder|anxiety disorder|Anxiety
Apartment hotel|Extended Stay Hotel
Apixaban|Eliquis
Appellation d'origine contrôlée|AOC
Apple Maps
Apple Wallet|wallet
Apple cake|Apple Cake|apple cake
Apple cider|Apple Cider
Apple crisp|apple crisp
Apple pie|apple pie|Dutch Apple Pie|Apple Pie
Apply
Appropriation bill|Tax Bill|Spending Bill
Approval voting|Approve
Apsis|APOGEE
Archaeology|Archaeologists
Architecture|Architectural
Arctic|Arctic region|arctic
Arena|Indoor Arena
Arepa
Arm triangle choke|Arm-Triangle Choke
Armoured fighting vehicle|AFV|armored fighting vehicles
Arrest warrant|Arrest Warrant|Arrest Warrants
Art Deco
Art exhibition|Art Show|Art Exhibition
Art museum|MOCA|Art Museum|Art Museums|Museums|Art Gallery
Art|Art Designs
Artificial intelligence|AI-powered|AI-Powered|AI ethics|Artificial Intelligence|AI|artificial intelligence
Arts festival|Dance Festival|Arts Festival|dance festival
Ascendant|rising sign
Ask price|Asking Price
Assault rifle|Assault Rifle|Assault Rifles
Assault|simple assault|Assaulting|Simple Assault
Assist (basketball)|APG
Assist (football)|Setting Up
Assisted living|Assisted living center|Assisted Living Center|assisted living|Assisted Living Facility
Association football positions|Pos.
Association football|Boys Soccer|boys soccer|football|Girls Soccer|Football|soccer|Soccer Player|Football Player|FOOTBALL|Soccer|Former Football Player|BOYS SOCCER
Asteroid belt|Asteroid Belt
Astrological sign|sign|zodiac sign|Zodiac Sign|Zodiac Signs
Astrology|Astrologer
Astronomical object|Celestial Bodies
Astronomical seeing|Seeing
Astronomy|Astronomers
Astrophysics|Astrophysicists
At bat|At-Bat
At-risk students|At-risk
Athletic conference|Athletic Conference
Athletic director|Director of Athletics|Athletics Director
Atlantic blue marlin|Blue Marlin
Atrial fibrillation|AF|AFib
Attempted murder|attempted murder|Attempted Murder
Attention deficit hyperactivity disorder|Attention Deficit Hyperactivity Disorder|ADHD
Auction|Auction house|Auctioned|Auction House
Audit committee|Audit Committee
Augmented reality|AR|AR headset
Aurora|Aurora Borealis
Austinite|Austinites
Author|Authors
Autism friendly|Autism Awareness|autism awareness
Auto detailing|Car Care
Auto mechanic|auto repair|Auto Repair
Auto rickshaw|Tuk-Tuks
Auto show|Automobile Show|Car Show|auto show|Motor Show|car show|motor show
Autoland
Automated external defibrillator|AEDs|AED
Automatic test switching|To The
Automatic transmission|Automatic
Automobile repair shop|Auto Garage|Auto Shop
Autumn leaf color|Fall Foliage|fall foliage|Fall Colors|Autumn Colors|Fall Color|Fall foliage
Autumn|Fall
Average-case complexity|On Average
Aviation accidents and incidents|Plane Crash|helicopter crash|Crash|Air Crash|plane crash|Plane Crashes
Aviation biofuel|LanzaTech|Lanzatech
Axe throwing|Axe Throwing|axe throwing
B
BLT
BMW in motorsport|BMW
Baby boomers|baby boomers|Boomers|Baby Boomers|Boomer
Baby food|Baby Foods|baby food
Baby powder|Baby Powder|baby powder
Bachelor's degree|bachelor's degree|Four-Year|bachelor's
Back pain|back pain|Back Pain
Back-fire|After Fire
Back-pass rule|Back Pass
Bad (economics)|Bads
Baggage handling system|Baggage Handling System
Baguette|French bakery
Bait car|bait car|Bait Car
Bake sale|Bake Sale
Baked Alaska
Baked potato|Baked Potato|baked potato
Ball culture|Ball House
Balloon boy hoax|Richard Heene|Balloon Boy
Balloon release|Balloon Launch
Banana bread|banana bread
Bánh mì|Banh Mi
Bank|Banking
Bar|Beer Bar|Bars|Lounge|Sports Bar|sports bar
Barbecue grill|Propane Grill|Ihaw-Ihaw
Barbecue sauce|barbecue sauce
Barbecue|BBQ|Bar-B-Q
Bare-knuckle boxing|Bareknuckle Boxing
Bariatric surgery|weight loss surgery|Weight Loss Surgery
Baroque|European-style
Barrel chest|Barrel-chested
Barricade|Barricades
Base on balls|Walks|BB
Baseball awards|Awards
Baseball glove|Baseball Glove
Baseball park|Ballpark
Baseball|Players|Baseball Player
Bashford Manor, Louisville|Bashford Manor
Basketball court|Basketball Court|basketball court
Basketball positions|Positions|Guard
Basketball winning streaks|Winning Streaks|winning streaks
Basketball|Boys Basketball|basketball team|girls basketball|Basketball team
Bath Beach, Brooklyn|Bath Beach
Batman in film|Batman Movie
Battery (crime)|Beatens
Battery electric vehicle|EV|BEV
Batting cage|Batting Cages
Be (Cyrillic)|The Be
Be More
Beach music|Beach Music
Beacon|Beacon Light
Bear spray|Bear Spray
Beard|The Beard
Beauty salon|Hair Salon
Béchamel sauce|White Sauce|White sauce
Beef Wellington
Beef bourguignon|Beef Bourguignon|Burgundy|Bourguignon
Beekeeping|Beekeeper
Beer festival|Beer Festival|beer festival
Beer garden|Beer Garden|beer garden
Beer hall|Beer Hall
Beer rating|Beer Advocate
Behavioral economics|behavioral economics
Belief|Beliefs
Bell-bottoms|Bell Bottoms
Bell-ringer|Bell Ringer
Bench (furniture)|Park Bench
Best, worst and average case|Best Case|Worst Case
Bestseller|Best-selling|Bestselling|Best Sellers List
Betting in poker|Check
Beurre noisette|Brown Butter
Bhikkhu|Monk
Big data|Big Data
Big-box store|Big Bo Box
Bilingual education|Bilingual School
Bill (law)|House Bill|Assembly Bill|Senate Bill
Billionaire|Billionaires
Bin bag|Trash-bag
Binary tree|Child|Left Child
Biology|Biological Science|Biologist|Life Science|Biological Sciences
Biomedical waste|Medical Waste
Biometrics|Biometric
Bipartisanship|Bipartisan
Bird migration|Migrating Birds
Bird|Birds|Baby Birds
Bird's eye chili|Thai Chili
Birth defect|Birth Defects|birth defects
Birth order|Third Child
Birth weight|Baby Weight
Birthing center|birth center|Birth Center|Birthing Center
Black beret|Black Beret
Black people|Black Men|Blacks|Black
Black rhinoceros|Black Rhino
Black-footed ferret|Black-Footed Ferret
Blind audition|Blind Auditions|blind audition
Block (Internet)|Banned
Blond|Blond Hair|Blonde Hair
Blood alcohol content|BAC
Blood donation|Blood Donors
Blood sugar level|Blood Sugar
Blood transfusion|Blood
Blooper|BLOOPER REEL
Blowing up|blowing up
Blue cheese|Blue Cheese
Blue|The Blue
Blue-ribbon panel|Blue Ribbon Panel
Board game|Board
Board of directors|board|Board of Trustees|board of directors|Management Board|Board of Directors|Board of Governors|The board|Directors|Board
Board of education|School board|school board|Board of Education|board|School Board|School Committee|school committee|School Board Member
Board of selectmen|First Selectman|Select Board|Selectmen
Boat|Boat Launch|boat launch
Boathouse|Boat House
Bob cut|Bob Haircuts
Bobblehead
Body armor|Body Armor|body armor
Body fat percentage|Body Fat Percentages
Bogeyman|Boogeyman|The Boogeymen
Boil-water advisory|Boil Water Order|boil water advisory|Boil Water Advisory
Boiled egg|Hard Boiled Eggs
Bokeh|Portrait Mode
Bomb disposal|Bomb Squad
Bonyad|Religious Foundation
Booing
Book discussion club|Common Read
Book|Books|books
Bookkeeping|Bookkeepers
Bookselling|Book Shop
Booster club|Booster
Booster pack|Starter Pack
Border Collie|Border Collies
Boston cream pie
Botany|Botanist|The Botanist
Bottled water|Bottled Water|Water|bottled water
Botulinum toxin|Botox
Boulevard|Blvd
Bounded complete poset|Consistently
Bourbon whiskey|bourbon|Bourbon|Kentucky bourbon
Bowl cut|Bowl Cut
Bowl game|College Football Bowl|Bowl|Bowl Game|bowl
Bowling form|Power Player|Power Players
Bowling league|Bowling League
Box office|box office|Box Office
Box score (baseball)|Box Score
Box wine|Boxed Wines|boxed wine
Boxing ring|boxing ring
Bracket (tournament)|TOURNAMENT BRACKET
Brain tumor|Brain Tumor|Brain Cancer
Brainstorming
Brake pad|Brake Pads
Brand ambassador|Brand Ambassador
Brand|Brands LLC
Bread pan|Loaf Pan|loaf pan
Bread roll|Dinner Rolls|dinner rolls
Bread|Loaves
Breakdown (vehicle)|Disabled Vehicle
Breakfast television|Morning Show|Morning
Breaking character|out of|Out Of|Out of
Breast cancer|breast|Breast|Breast Cancer|breast cancer|breast cancer research
Breastfeeding in public|Breastfeeding in Public
Brewed coffee|Brewed Coffee
Brewery|Brewing Co.
Brewing|Brewer|Brewing Company
Bridal shower|Bridal Shower
Bridge|Road Bridge
Brigadier general (United States)|Brig. Gen
Bright spot|Bright Spot|bright spot
Brightwork
Broadcasting|Media and Entertainment
Broadway East, Baltimore|Broadway East
Brown trout|Brown
Browser game|Games
Bruise|Bruised
Brussels sprout|Brussels Sprouts|Brussels sprouts
Brute-force attack|Brute-force
Bubble tea|Boba
Buddy check|Buddy Check
Buffalo wing|Buffalo sauce|Buffalo Sauce
Building code|Residential Building Code
Building|Indoors
Building-integrated photovoltaics|solar roof|Solar Roof
Built environment|Built
Bulldog|English Bulldog
Bulletproof vest|Bulletproof Vest
Bullying
Bundt cake|Bundt Cakes|Bundt
Bunk bed|bunk beds
Buprenorphine|Suboxone
Bureaucrat|Bureaucrats
Burglary|Burglarized
Burgomaster|Burgermeister
Burial|burial site
Bursting
Bus driver|bus driver|Bus Driver
Bus|Bus Operator
Business card|Membership Card
Business class|Business Class
Business failure|Going Out of Business|Going-out-of-business
Business incubator|Business Incubator
Business marketing|B2B Marketing
Business oligarch|Russian billionaire
Business process|Business Processes
Business
Businessperson|Small Business Owners
Butter chicken|Butter Chicken Company
Butternut squash|Butternut Squash|butternut squash|Butternut
Buzz cut|Buzz
Buzzer beater|Buzzer Beater
By-election|Special Election
Bye (sports)|Bye Week|bye week
Bypass (road)|Bypass Road
CT scan
Cabbage soup diet|cabbage soup diet|Cabbage Soup Diet
Cabinet (government)|Cabinet Member
Cable television|Cable TV
Cadency|Differ
Caffè mocha|Mocha Coffee
Cake pop|Cakepops
Cakery|Cake Shop
California roll|California Rolls
Call centre|contact center|Contact Center
Calorie|The Calories
Camp Washington, Cincinnati|Camp Washington
Campaign advertising|Campaign Ads
Campaign manager|Campaign Manager
Campervan|Camper Van
Campsite|Campgrounds
Campus police|University Police|University police
Cancellation (television)|Canceled
Cancer Alley
Cancer in dogs|Cancer in Dogs
Cancer survivor|Cancer Survivor|cancer survivors
Cancer|Cancer Services|Cancer Patient|Cancer Diagnosis|Against Cancer|Cancer Patients
Candle|scented candles
Candy corn|George Renninger|Candy Corn|candy corn
Cangue|Tcha|Chinese board|Chinese Board
Cannabidiol|CBD
Cannabis (drug)|Marijuana|recreational marijuana|Recreational marijuana|Recreational Marijuana|Weed
Cannabis use disorder|Cannabis Use Disorder
Canon law|canon law
Cantillation|Trop
Canvassing|Canvassing Board
Capital city|Capital City|Capital|District Seat
Capital murder|capital murder|Capital Murder
Capital punishment|Death|To Death
Capsule wardrobe|Capsule Collection
Captain (United States)|US captain
Captain (association football)|Team Captain|Captained
Captain (cricket)|County Captain
Captain (naval)|Capt.
Car dealership|Car Dealerships|Car Dealer
Car model|Model
Car rental|Rental Cars|rental cars
Car wash|Car Wash
Car|Auto|Vehicle|Vehicles
Caramel|caramel sauce
Caramelization|Caramelized Onions|Caramelize
Carbon dioxide laser|CO2
Carbon dioxide|CO2
Carbon footprint|Carbon Footprint
Carbon group|Group IV
Carbon monoxide|Carbon Monoxide|carbon monoxide
Carbonated water|Seltzer|Soda|Sparkling Waters|soda
Card (sports)|Fight Card
Cardiac arrest|Sudden Cardiac Death
Cardiac surgery|Open Heart Surgery
Cardiopulmonary resuscitation|CPR
Cardroom|Poker Room
Career development|Career Development
Caregiver|caregiving|caregiving services|Caregiving
Caretaker manager|A.I.
Carjacking|Carjacked
Carne asada|carne asada|Carne Asada
Carnitas
Carnivore|Meat Eaters|Flesh-eating
Carolina style|Carolina-style|Carolina
Carpal tunnel|Carpal Tunnel
Carpool|ride-share|Carpooling|Ride Sharing|Ride-share
Cash register|Cash Register
Cashback reward program|credit card rewards
Casino|Gambling Hall
Cask strength|Barrel Proof
Cast iron|Cast Iron
Cast-iron cookware|Cast-Iron Skillet|cast iron pan
Casting (performing arts)|Open Casting Call|Casting Call
Catalytic converter|Catalytic Converters
Category of being|Ways of Being
Caucus chair|Caucus Chair
Caucus|Minority Caucus Chairman
Caving|Spelunking
Celebrity chef|Celebrity Chefs
Celebrity|Celeb|Celebrities|Celebs|Famous People|famous people|CELEBS
Cell site|CELL TOWERS|cell towers
Center (basketball)|Big Man
Center (gridiron football)|Football Center
Center of excellence|Center of Excellence
Central business district|CBD|Business District
Centrul Național Media|National TV
Cereal|Grains
Cerebral palsy|Cerebral Palsy
Ceremonial ship launching|Launched|Launching
Ch (digraph)|Ch.
Chain store|Restaurant Chain
Chalk talk|Chalk Talk
Challenge coin|Challenge Coin
Chamber of commerce|Chamber of Commerce|Chamber Of Commerce|Chamber
Champagne|Rosé Champagne
Chancellor (education)|University President|Vice Chancellor
Changing room|Locker Room
Characters of Diablo|Lilith
Charitable organization|Charities|Charitable|Charity Event
Charter school|CHARTER SCHOOLS|Charter School|Charter-school|Charter High School|charter school
Chartplotter
Cheat sheet|Cheat Sheet
Checkdown|The Checkdown
Checking (ice hockey)|Check
Cheddar cheese|White Cheddar|Cheddar Cheese|white cheddar
Cheerleading|cheer|SPIRIT Club|Cheer
Cheese puffs|Cheese Balls
Cheesecake|cream cheese pie
Chef de cuisine|Executive Chef
Chemistry education|Chemistry Class
Chemistry|Department of Chemistry
Chemotherapy|Chemo
Chengyu|4 Character
Cheque|Check
Cherry ice cream|Cherry Garcia
Cherry pie|Cherry Pie
Chevrolet small-block engine|Small Block|LT1|small block
Chevrolet straight-6 engine|Blue Flame
Chicago-style hot dog|Chicago Style Hot Dog
Chicago-style pizza|Chicago-style
Chicken and dumplings|chicken and dumplings|Chicken and Dumplings
Chicken and mushroom pie|chicken pie
Chicken as food|Chicken|Chicken Dinners|Chicken Dinner|Chicken Breast|chicken dinner
Chicken coop|chicken coop
Chicken fingers|Chicken Tender|Chicken Tenders
Chicken fried steak|Chicken-Fried Steak
Chicken or the egg|Which Came First
Chicken sandwich|Chicken Sandwich|chicken sandwich
Chickenpox|Chicken Pox
Chief administrative officer|Chief Administrative Officer
Chief deputy|Chief Deputy
Chief executive officer|CEO|The CEO|CEOs|the CEO|C.E.O.|Founder and CEO|Chairman and Chief Executive|President and CEO|co-CEO|co-CEOs
Chief financial officer|Finance Director
Chief investment officer|Chief Investment Officer
Chief product officer|Chief Product Officer
Child abduction|Abduction of Child|Child Abduction
Child abuse|Child Abuse|child abuse
Child actor|Child Actors|Teen Actors
Child care|Child Care|Daycare
Child labour|Child
Child marriage|child marriage
Child pornography|Child Porn
Child poverty|child poverty|Child Poverty
Child prodigy|Wonderkid
Child sexual abuse|child molestation|Sexual|child molester
Child tax credit|child tax credit|Child Tax Credit
Childbirth|Give Birth|Giving Birth|Birth
Children's literature|children's books|Children|children's|Children's Books
Children's museum|children's museum
Chili pepper|Chili
Chimney sweep|Chimney Sweep Service
Chimpanzee|Chimp|Chimps
China City, California|China City
Chinese economic reform|Opened Up
Chinese guardian lions|Lion Dogs
Chinese intelligence activity abroad|Chinese spying
Chocolate chip cookie|Chocolate Chip Cookie|Chocolate Chip Cookies|chocolate chip cookie|Toll House Cookie|chocolate chip cookies
Choir|Choral Society
Chow mein|Chow Mein|chow mein
Christmas and holiday season|Holidays|Christmas Season|holiday season|Christmas|Christmastime|Christmas holidays|The Holidays|Holiday Season|Holiday Shopping Season
Christmas by medium|Christmas Movie
Christmas cookie|Christmas Cookies
Christmas lights|Holiday Lights|Lights|Christmas Lights|Holiday Light
Chroma key|Chroma
Chronic condition|Chronic Diseases
Chronic obstructive pulmonary disease|COPD
Chronic pain|chronic pain
Chronic wasting disease|Chronic Wasting Disease|CWD
Chueo-tang|Chueotang
Church (building)|Church Building
Churrascaria|Brazilian steakhouse
Cider house|Cider House
Cider|Cider Festival
Cigar bar|Cigar Bar
Cincinnati chili
Cinnamon roll|Cinnamon Rolls|cinnamon rolls
Circular economy|Circular Economy
Circulatory system|Blood Supply
Circumnavigation|Round the World|world cruise
Citizen science|Citizen Scientists
Citizen survey|Citizen Survey
Citizenship of Russia|Russian citizen|Russian citizens
Citrus production|Citrus
Cittern|Zisters
City attorney|Town Attorney|city attorney|City Attorney
City commission government|City Commissioner|City Commission|The City Commission|city commission|city commissioner
City council|city council|council|councilwoman|City Councilman|Council|council member|Councilman|Council Member|The City Council|Councilmembers|Common Council|City Council
City manager|town manager|City Officials
City|The city|The City|the city
Civic Center, Denver|Civic Center Park
Civil and political rights|Civil Rights
Civil society|Civil Society
Civil war|CIVAL WAR|Cival War
Civilian casualties|targeting civilians|Targeting Civilians
Clamshell design|Flip Phone
Class (education)|School (Class)
Class ring|class rings
Classic car|Classic Cars|classic cars
Classic|Modern Classics
Classical music|Classical
Classical swine fever|Swine Fever
Classified information|Top-secret
Cleaning agent|cleaning products|Cleaning Products
Climate change mitigation|Climate Action
Climate change|climate change
Clinic|Health Clinic
Clinton health care plan of 1993|Health Care Plan
Clock|wall clock
Closing credits|Closing
Clothing|men's clothing|Men's Clothing
Cloud computing|Cloud|Cloud Computing
Cloud|Cloudy
Coach (baseball)|Bench Coach|bench coach|Hitting Coach|hitting coach|pitching coach
Coach (basketball)|Head Basketball Coach
Coach (sport)|Asst|the Coach|Co.|assistant
Coachbuilder|Auto Body
Coastal fish|Coastal Fish Company
Coastline of Brazil|Brazil's coastline
Coat of arms|Arms
Cobb salad|Chopped Salad|chopped salad
Cobble Hill, Brooklyn|Cobble Hill
Cockfight|Cockfighting
Cockroach|Roaches
Cocktail|Cocktail Bar
Code page 852|17U
Coffee cake|Coffee Cake
Coffee cup|Coffee Cup
Coffeehouse|Coffee Shop|Coffee Bar|Coffee House|Cafe Chain
Cold blast|Cold Blast
Cold front|Cold Front
Cold weather rule|Cold Weather Rule
Cold|Coldest
Collaborative writing|Co-Authoring
College and university rankings|Global Universities Rankings
College football on television|College football on TV|College football TV
College ice hockey|COLLEGE HOCKEY
College soccer|COLLEGE SOCCER|college soccer|College Soccer
College-preparatory school|College Prep|Preparatory High School
Colonel (United States)|U.S. Army Colonel
Colonel|Air Force Colonel
Color scheme|Color Scheme
Colorectal cancer|Colon Cancer|colon cancer|Colon cancer
Coloring book|Coloring Books
Comfort food|Comfort Foods|Comfort Food
Comic timing|Pregnant Pause
Coming into force|Into Effect
Coming out|Comes Out|Came Out as Gay
Commemorative plaque|historical marker|Historical Marker
Commercial property|commercial real estate|Commercial Real Estate
Commissioners' court|Commissioners Court
Committee|Legislative committee|Commission|Cmte|Steering Committee|steering committee
Committeemen and Committeewomen (Cook County, Illinois)|Democratic committeeman
Common carp|European carp
Common cause and special cause (statistics)|Special Cause
Common cold|Colds|A Cold
Common name|Commonly
Commonwealth's attorney|Commonwealth Attorney|Commonwealth's Attorney
Communism|Commies
Community centre|Community center|Community Club|Community Center|community center
Community college|Community College|Community Colleges
Community development|Community Development Corporation|Community Development
Community health|CHS|Community Health
Community mental health service|Community Mental Health
Community radio|Community Radio|community radio
Community school (England and Wales)|Community School|County Schools
Commuter rail|Commuter Rail
Compact executive car|Compact Luxury
Competitive eating|Eating Contest
Complete streets|Complete Streets
Compost|compost pile
Computer mouse|DPI|Wireless Mouse|wireless mouse
Computer science|Computer Science|computer science
Computer security|Cybersecurity|Cyber-security|Security
Computer-aided design|CAD
Computer-generated imagery|CGI
Concept car|Concept|Concept Cars
Concert|Concert Series|Live Performances
Conciliation|Conciliation, Inc.
Concrete masonry unit|Cinder-Block|Cinder-block
Conference hall|Conference Room
Conflict resolution|conflict resolution|Conflict
Conformation show|Dog Shows
Congressional staff|Staffers
Conjunct|Her Daughters|Her Daughter
Conscription|Called Up|military draft|Military Draft
Consent decree|consent decree
Conservation area (United Kingdom)|Conservation Area
Conservation movement|conservationists
Conservation officer|Conservation Officer|Game Warden|Game Wardens|Wildlife Officers
Constitution of Texas|Texas Constitution
Constitutional amendment|Constitutional Amendments
Constitutional law
Construction|Construction Projects|construction site|Build
Consumer protection|Consumer Protection
Contact lens|contacts
Contemporary art|Contemporary Art
Continuing resolution|CR
Continuous positive airway pressure|CPAP
Contract|Re-Signing|contracts law
Control commission|Control Commission
Controlled-access highway|Through Streets
Convenience food|Packaged Foods|Processed Foods
Convenience store|Convenience-store|Mini Market|mini market|convenience store|Convenience Store|Quick Mart|Convenience Stores
Convention center|Event Centre|Convention Facilities|convention center|Exhibition Center
Conversation
Conversion (gridiron football)|Extra Points|PAT|Extra Point
Conversion therapy|Conversion
Cook-off|Chili Cook Off|Chili Cook-Off
Cookie cutter|Cookie Cutters|Cookie-cutter
Cookie dough|Cookie Dough|cookie dough
Cooking
Cookware and bakeware|Cookware
Cool (aesthetic)|Coolest
Cooperating Associations|Friends group
Coral reef|coral reef
Cordon bleu (dish)|Cordon Bleu
Corduroy road|Log Road
Corn fritter|Corn Fritters
Corn maze|Corn Maze|corn maze
Corn starch|Cornstarch
Cornerback|The Cornerback
Coroner|County Coroner|Coroner's office
Corporate branding|Corporate Branding
Corporate development|Developing
Corporate title|C-suite
Corps|Army Corps
Cosmetics|Beauty Products|Beauty|Makeup|Making Up
Cosmic distance ladder|Dist
Costume party|Halloween Parties|Halloween party|Halloween Party|Halloween
Cotton gin|The Cotton Gin
Cotton mill|Cotton Mill
Councillor|Councilmember|Councilman
Council–manager government|City Administrator
Count (baseball)|Full Count
Counter run|Counter Trey
Counter-terrorism|Counterterror
Country club|Country Club|Golf and Country Club|Golf & Country Club
Country of origin|Made In
County administrator|County Administrator
County council|County Council
County highway|County Road|County Highway
Coupé|Coupe
Course credit|COLLEGE CREDIT
Court order|Court-ordered|Court Ruling
Coverage map|coverage map
Covington Police Department (Kentucky)|Covington Police Department
Cowardice|Cowardly
Coworking|Co-working|Coworking Spaces|Coworking spaces
Crab stick|Crab Stick
Craft|Craft Fair
Cranberry sauce|cranberry sauce|Cranberry Sauce
Cream cheese|Cream Cheese
Cream of mushroom soup|cream of mushroom soup
Cream pie|Banana Cream Pie|coconut cream pie
Credibility|credibly
Credit bureau|Credit
Credit card debt|Credit Card Debt|credit card debt
Credit card|credit card|Credit|Credit Cards|Credit Card|credit cards
Credit score|credit score|Credit Score
Credit union|credit union|Federal Credit Union|Credit Union
Crème brûlée|Catalana
Crime statistics|Crime Statistics
Criminal defense lawyer|Criminal defense
Criminal investigation|Criminal Investigation
Criminal justice|Criminal Inquiry
Critic|Critics
Criticism|Criticizing
Cross (football)|Crossing
Cross country running|Cross-Country Runners|cross country|Cross-country Championships|CROSS COUNTRY|Cross Country
Cross processing|X-Pro
Crossover music|Crossed Over
Crossroads, Kansas City|Crossroads Arts District
Crow's nest|Crow's Nest
Crowbar (tool)|Pinch Bar
Cruelty to animals|Cruelty to Animals|Animal Cruelty|Animal Exploitation|Animal Abuse|animal cruelty
Cruise line|Cruise Line|cruise line|Cruise Lines
Cruise ship|Cruises|cruise ship|Cruise-ship|Cruise Ship|Cruise
Cruising (driving)|cruise night
Crushing (execution)|Crushed To Death
Crust (baking)|PIE CRUSTS
Crwth|CRWD
Cryogenics|Low Temperature|Low Temperatures
Cuban medical internationalism|Cuban doctors
Cuban sandwich|Cuban
Cuddy (cabin)|Cuddy Cabin
Cuisine|Food & Drinks
Cult film|Cult Classics
Cultural District, Pittsburgh|Cultural District
Cultural resources management|Cultural Resources
Culture war|Culture War|Culture Wars
Cure|The Remedy
Curling|Curling Rink|curling rink|Curlers
Custard pie|Custard Pie
Cyanobacteria|blue-green algae
Cyberbullying|Online Abuse
Cystic fibrosis|cystic fibrosis|Cystic Fibrosis
D
D-pad
DVD region code|Region 2|Region 4|Region 1|All-Region
Dairy product|dairy products|Dairy Products
Dance music|The Dance
Dangerous goods|Hazardous Chemical|HAZMAT team|hazardous chemical|hazmat team|Hazmat team
Dark matter|Dark Matter
Data compression|Compressing
Dating
Day trading|Intraday
Daylight saving time|Daylight Saving|daylight saving time|Daylight savings time|Daylight Savings Time|DST|Daylight Saving Time|Daylight
DeLorean time machine|DeLorean
Deacon|Diaconate
Deal of the day|Flash Sale
Dean (education)|Dean of Students
Death penalty (NCAA)|death penalty
Death row|Death Row
Death threat|Death Threats|death threats
Debate|Discussing
Deborah Davis (hazzan)|Deborah Davis|Debbie Davis|Davis
Debt|Debts
Deck (building)|Roof Deck
Declassification|Declassified Documents
Decompression (diving)|Safety Stop
Deep Ellum, Dallas|Deep Ellum
Deep fryer|Deep Fryer
Deep frying|Deep-frying|deep-frying
Deep sea|Deep-sea
Deer|Cervidae
Defamation|Defamation Lawsuit
Defenceman|Defense|Defenseman
Defender (association football)|WB|CB|Dr.|LB|Defend|FB|RB
Defense (legal)|Legal Defense
Defensive back|Defensive Backs|defensive back|DB|Secondary|DBs|Defensive Back
Defensive end|De|Defensive End|DE
Defensive spectrum|Most Demanding
Delicata squash|Delicata|Delicata Squash
Delmonico steak|Delmonico
Deloitte Technology Fast 500|Fast 50
Democracy|Democratic state
Dengue fever|Dengue
Dentistry|Dentists|Dental Care|DENTAL PRACTICE|dentists
Deoxycholic acid|Kybella
Department store|Department Stores|Department Store
Dependability|Dependable
Dermatology|Dermatologist|Dermatologists|dermatologists
Description|Describes
Desert island|Desert Island
Design choice|Design Choices
Designated hitter|DH|DH.
Design–build|Design and Build
Desktop computer|desktop computer|Desktop Computer
Detective|Det.|Investigators
Determinacy|The Infinite Game
Detroit Red (apple)|The Detroit Red
Developed country|Wealthy Countries
Developmental psychology|Child Psychologist
Device driver|Drivers
Deviled egg|deviled eggs
Diary|DIARIES
Die-in|Die In
Dieting|Diet Plan
Digital library|Digital Library
Digital rights management|DRM
Digital single-lens reflex camera|DSLR
Digital transformation|Digital Transformation
Digital video recorder|DVRs|DVR
Dim sum|Dim Sum|dim sum
Dine and dash|Dine-and-dash|dine and dash
Diner|American diner
Dining in|Dining In|Dining Out
Dining room|Dining Rooms|Dining Room
Diplomacy|Diplomatic|Diplomats
Diplomatic mission|U.S. Embassy
Diplomatic rank|Special Representative|special representative
Dipping tobacco|Chew
Direct current|DC
Direct-quadrature-zero transformation|Park Transformation
Director of communications|Director of Communications|Director of Communication|Communications Director
Dirt track racing|Dirt Track
Disability|Disabled|Persons with Disabilities
Discipline|Disciplinary
Discount store|Discount
Discounts and allowances|Student Discounts
Discourse marker|You Know
Discovery (observation)|New Found
Disease|medical conditions|Medical Conditions|Illness|SICK|Health Problem|Health Problems|health problems
Dish (food)|Dishes
Disinformation|Disinformation Campaigns
Displacement (ship)|Displaced
Display driver|Display Driver
Display resolution|Video|High Quality|The Video
Disposable product|Single-use
Dispute resolution|Dispute Resolution
Disruptive mood dysregulation disorder|DMDD
Diss (music)|Disses
Distillation|Distilling Co.|Distillery
Distribution center|Distribution Centers
District attorney|D.A.|Office|Circuit Attorney|district attorney's office|District Attorney|D.A.s|District Attorney's office|District Attorney's Office
District|Municipal Utility District
Districts of Malta|District 2
Dive bar|Dives|dive bar|Dive Bar
Dive computer|dive computers|Dive Computers
Dividend|Dividends
Diving chamber|hyperbaric chamber
Divorce|Ex-Husband
Doctor (title)|Dr|Dr.
Dog breed|All Breeds|dog breed|dog breeds|Dog Breeds
Dog grooming|Pet Grooming
Dog whistle|Dog Whistle
Dog|Dogs|man's best friend
Dogs in warfare|K-9s
Dogtown, St. Louis|Dogtown
Domain of a function|Source
Domestic turkey|turkey farm|Turkey Farm
Domestic violence|domestic abuse|Domestic Abuse|Domestic Violence|Abusive|domestic violence
Door|french doors|French doors
Dormitory|Dorm Room
Dot-com bubble|Dot
Double Dutch (jump rope)|Double Dutch
Double album|Double Album|double album
Double play|Double Play|double play
Doubleheader (baseball)|DH
Doughnut|glazed doughnuts|Doughnut Co.|Glazed Doughnuts|Cake Doughnut|Donut
Dousing|Doused
Down (gridiron football)|third down|Fourth-down|fourth down
Down syndrome|Down Syndrome
Downloadable content|DLC
Downtown Memphis, Tennessee|Downtown Memphis|Downtown
Downtown New Orleans
Dozen|Dozens
Draft (sports)|Drafting
Drag racing|Drag Racing|Drag Race|drag race|Drag
Dragon's egg|Dragon Eggs
Drainage basin|River Basin
Drainage system (geomorphology)|river system
Drama|Dramatically
Drawing board|Drafting Table
Dress code|Dress Code|Getting Dressed|Getting dressed
Dress shirt|Button Down
Dress-up|Dressed Up
Dried and salted cod|Baccala
Drifting (motorsport)|Drift Cars
Drink|Beverage Company|beverage|Beverage
Drinking straw|Straws|Straw
Drive time|afternoon drive|Afternoon Drive
Drive-by shooting|Drive-By Shooting|drive-by shooting|Drive-by
Drive-in|Drive In
Drive-through|Drive-Thru
Driving under the influence|OVI|DUI|BAC|Drunk Driving|DUIs|Driving While Intoxicated|driving drunk|OWI|DWI
Drop goal|FGs
Dropping in|Dropping In
Dropping out|Dropping Out Of School
Drought|Dry
Drug czar|Drug Czar
Drug overdose|Overdose Drug
Drug possession|Possession of a Controlled Substance
Drug resistance|Drug-resistant
Drug-related crime|Drug Bust|drug bust
Drunk drivers|drunk driver|Drunk Driver
Dry eye syndrome|Dry Eye
Dry suit|Drysuits
Dual-clutch transmission|DCT
Dual-sport motorcycle|Dual Sports
Ductal carcinoma in situ|DCIS
Duel|Dueling
Dump truck|Dump Truck|dump truck
Dune|Sand Dunes
Dust storm|Dust Storm|dust|Dust
Dutch baby pancake|Dutch baby
Dutch-based creole languages|Dutch-based
Dysgeusia|Metallic Taste
Dyslexia
E
E-book|E Book|eBooks
EMASS|EMass
Early voting|Early Voting
Earned run average|ERA
Earnings before interest and taxes|operating profit|Operating Profit
Earthquake warning system|Earthquake Early Warning System|earthquake early warning system|Early Earthquake Warning|Earthquake Warning
Earthquake|Quake
Earthship
East End, Houston|East End|the east end
Eastern equine encephalitis|Equine Encephalitis|EEE Virus|Eastern equine encephalitis virus|Eastern Equine Encephalitis|E|EEE
Eating disorder|Eating
Eating
Ecology|Eco-Friendly
Economic development|Economic Development|economic development|Economic Development Corporation|Economic|economic development corporation
Economic growth|Economic Growth|Growth
Economic inequality|income inequality
Economic power|Economic Power
Economics|Economic Analysis
Economy class|Economy
Edge (geometry)|Side
Editing|Associate Editor|Executive Editor
Editor-at-large|Editor at Large|Editor-At-Large
Editorial board|editorial board
Editorial|Opinion|Leader
Education|Education Program|Educators
Educational technology|eSchool
Effectiveness|Effectively
Effects of tropical cyclones|hurricane damage
Efficient energy use|Energy-efficient
Egg roll|egg roll
Egging|egg attacks|Egg Attacks
Eggs Benedict|Benedict
Election commission|Board of Elections|Board of elections
Electric bicycle|eBike
Electric car|Electric|EV|electric cars|Electric Cars|Electric SUV
Electric motorcycles and scooters|Electric Motorcycle|electric scooter|Electric Scooter|Electric Motorcycles|electric motorcycle|Electric Scooters
Electric power system|Power System
Electric power transmission|High Voltage Power Line|Power|power lines|Power Lines
Electric power|Electric Power
Electric vehicle|EVs
Electrical engineering|Electrical
Electrical network|Electrical Systems Inc.
Electrical resistivity and conductivity|To Conduct
Electrical substation|Sub-Station
Electrical wiring|Electric Wiring
Electricity generation|Electricity
Electrocardiography|EKG
Electronic cigarette|Vaping|vaping|E-cigs|Vaping Devices|E-cigarettes|Electronic Cigarette|Vapes|e-Cig|E-cigarette|vapes|Vape
Electronic control unit|ECU|ECUs
Electronic dance music|EDM
Electronic funds transfer|E CHECK
Electroplating|Electro-Plating Services
Elm|Elm Tree
Email|Reply To
Embargo (academic publishing)|Moving Wall
Emergency landing|Crash Lands|Emergency Landing
Emergency management|Disaster Management|Emergency Management|Emergency Preparedness|Earthquake Drill
Emergency medical services|ambulance service|Rescue Worker|EMS|Emergency Services|EMS.|Emergency Medical Services
Emergency medical technician|EMT|EMTs
Emergency medicine|Emergency Care
Emergency physician|ER doctor
Emergency vehicle lighting|Dashboard Lights
Emeritus|Professor Emeritus
Emotional intelligence|emotional intelligence|Emotional Intelligence
Emotional support animal|ESA
Employment|Employer|Coworkers
End zone|end zone
End-of-life (product)|End-of-life
Enduro race|Enduro Race
Energy bar|The Breakfast Bar
Energy conservation|Energy Saving
Energy industry|Energy Producers
Energy|Energizes
Engagement party|Engagement Party
Engagement ring|Engagement Ring|Engagement Rings
Engagement|Fiancé
Engine control unit|Engine Computer
Engineering
English modal verbs|Couldn't|shouldn't|Have To|Have to|Shouldn't|Cannot|Has To
English passive voice|Said To
Enthusiasm
Entitlement
Entrepreneurship|CEO|Founder|serial entrepreneur|Young Entrepreneur|Entrepreneurs|Co-founder|Entrepreneur|Co-Founder|Serial Entrepreneur
Environmental education|Environmental Education
Environmental protection|Environmental Protection
Environmental resource management|Environmental Management
Environmentalism|Environmentalists
Epidemiology of domestic violence|DV
Epidermolysis bullosa|EB
Epileptic seizure|Seizures
Epinephrine autoinjector|EpiPen
Episcopal see|See
Equal pay for equal work|Fair Pay
Equals sign|Equal To
Error message|Error
Escalator|Escalate
Escape velocity|Escape Velocity
Espionage|Spying|Russian spy
Esquire|Esq.
Estate sale|estate sale
Eternity|Of All Time
Ethnic group|Philippine-born
Ethnic joke|Racist Jokes
Eucharist|Holy Communion
Eurasian brown bear|European Brown Bear|European brown bear
Eurogame|German-style
Evangelicalism|Christian Evangelical|Evangelicals
Everyday life|Everyday Life
Eviction|Notice to Quit
Evolution of dinosaurs|Dinosaur Evolution
Ex post facto law|Retroactively
Exchange-traded fund|ETF|ETFs
Execution-style murder|Execution-style
Executive order|Executive Order
Exercise|The workout|Workouts|Exercised|Fitness|Exercises|Working Out|Workout
Exhibition game|preseason game|Preseason Game|Overseas Tour
Existence of God|Is there a God
Existential quantification|For Some
Expansion team|Expansion
Experience point|Level Up
Experiential learning|Hands On Training
Explanation
Exploratory committee|exploratory committee
Exsanguination|Bleed Out
Extra innings|Extra Innings
Extraterrestrial life|E.T.
Extraversion and introversion|Introverts
Extreme poverty|Extreme Poverty
Extreme sport|Action Sports
Extreme weather|Extreme Weather
Eye drop|Eyedrops
Eye examination|Eye Test
Eyebar|Bar Chain
F|F'|F.
FIFA eligibility rules|Eligible
Face (geometry)|Cell
Face (professional wrestling)|fan favorite|Fan Favorite
Facelift (automotive)|Facelifted
Facial recognition system|Facial Recognition Technology|Face Recognition|facial recognition technology|Face Unlock|face
Fad|Must Have
Fahrenheit 9/11 controversies|Pete Damon
Fairgrounds, New Orleans|Fairgrounds
Fairy godmother|Fairy Godmother
Faith healing|Healing
False accusation|False Claim
False arrest|False Arrest
False statement|False Statement
Family (biology)|Family Services
Family business|Family-owned
Family farm|Family Farm|Family Farms|family farm
Family medicine|Family Medicine|Family Health|family medicine
Family support|Family Support Services
Family|Family Member|Family Members|Family Services|Grandkids
Fan mail|Fan Mail
Fangame|Fan Game
Fantasy football (American)|fantasy football|Fantasy Football
Fantasy sport|Fantasy League
Fantasy|Fantastical
Fare|Reduced Fares|FARE|Airfare
Farm-to-market road|Ranch Road|Farm Road
Farm-to-table
Farmers Market, Dallas|Dallas Farmers Market
Fashion design|fashion icon|Fashion Icon
Fashion doll|Fashion Dolls
Fashion|Fashion Statement
Fast casual restaurant|Fast Casual Restaurants|Fast-Casual
Fast food restaurant|Fast Food Restaurant|Fast Food Restaurants|QSR|Burger Joint|Quick Service Restaurants|Fast-Food Restaurants|Fast Food Chains|Fast-Food Chains
Fast food|Fast-food|Fast Food|Would You Like Fries With That
Father-daughter dance|Father-Daughter
Faubourg
Feces|Bird Droppings|DOO DOO
Federal architecture|Federal-style
Fee|Annual Fee|annual fee
Feeding the multitude|Loaves and Fishes
Fellow|Senior Fellow
Feminine hygiene|Feminine Hygiene Products|Menstrual Products|feminine hygiene products
Feminism|Feminist
Festival|Festivities|Festive|Events
Fettuccine Alfredo|Alfredo
Field goal|Field Goal|FG|Kicking|field goal
Field hockey|Field Hockey|field hockey
Fifth year|Fifth-year|Fifth Year
Fighting game|Fighting,
Fighting in ice hockey|Fights
Figma
Filling station|Gas Station|gas station|Filling Station|The Gas Station
Film analysis|Film Analysis
Film director|directed by|Directed By|Writer-director
Film festival|Film Festival|Film|film festival|International Film Festival
Film industry|Industry
Film laboratory|The Film Lab
Film poster|movie poster|Movie Poster
Film producer|Hollywood producer
Film score|Film
Film studies|Film Study
Film|Movies|Movie|The Screen
Finance|Finances
Financial adviser|Financial Advisors
Financial endowment|Endowed Professor
Fine art|Fine Arts
Finger joint|Finger Joint
Fire authority|Fire & Rescue|Fire and Rescue|fire and rescue
Fire department|fire department|Fire Departments|Fire Dept|Fire Protection District|Fire Department|Protection District
Fire drill|Fire Drill
Fire engine|Ladder Truck
Fire extinguisher|Fire Extinguisher
Fire hose|Hoses
Fire lookout|Fire Watch
Fire marshal|Fire Marshals|Fire Marshal
Fire station|Fire Station|station|fire station|fire stations|Station
Firearm|Guns
Firebreak|Fire Breaks
Firefighter|Fire Co.|Fire Danger|Fire Rescue|Firefighters|fire
Firefighting
First Friday (public event)|First Friday
First aid|First Aid|first aid
First baseman|1B|first base|1B/OF
First day of school|First Day of School
First fix and second fix|Outside Work
First grade|Year 1
First lieutenant|1st Lt|1st Lieutenant
First look deal|First Look
First-class cricket|FC
First-person shooter|FPS
Fiscal year|Fiscal Year|Second Quarter
Fish and chips|Fish & Chips|Fish and Chips
Fish market|Fish Market|Seafood Market
Fish oil|Fish Oil Supplement
Fishery|Marine Fisheries
Fishing|Deep Sea Fishing
Five-star rank|Five-star
Flagship|Flagship Store
Flare gun|Flare Gun
Flash flood watch|Flash Flood Watch
Flash mob|Flash Mob
Flat (gridiron football)|Flats
Flathead engine|Flathead
Flattery|Flattering
Flea market|Flea Market|flea market
Flight attendant|Flight Attendants
Flirting|hit on|Hit On
Float (parade)|Parade Float
Floating wind turbine|Floating Wind Turbines
Flood alert|Flood Watch|flood watch
Flood warning|Flood Warning
Flood|Flooding
Floor (legislative)|House|House Floor
Floor leader|Caucus Leader
Floppy disk|floppy disks
Florida stone crab|Stone Crabs|stone crab
Florida–Georgia football rivalry|Florida-Georgia|Cocktail Party|Florida vs. Georgia|Georgia-Florida|Florida Georgia|FLORIDA-GEORGIA|World's Largest Outdoor Cocktail Party|Georgia/Florida
Flu season|flu season|Flu Season
Fluoroacetate
Fluorosurfactant|PFASs|PFAS
Flush toilet|Flush
Flyweight (MMA)|women's flyweight
Fog|Foggy
Foie gras|foie gras|Foie Gras
Folk art|Folk Art
Folk hero|American Folk Heroes
Fontainebleau, New Orleans|Marlyville-Fontainebleau
Food bank|Food Bank|food bank|Food distribution center|Foodbank|food pantry|Food Pantry
Food booth|Food Stall
Food cooperative|food co-op|Food Co-op
Food drive|Food Drive
Food festival|Food Festival
Food group|Food Group|The Food Group
Food intolerance|food intolerance
Food photography|Food Stylist|Food Photography
Food safety|Food Inspections
Food security|food insecurity|Food|Food Insecurity
Food spoilage|spoiled food|Spoiled Food
Food truck|food truck|Taco Truck|taco truck|Food Truck
Food|People Food|The Foods
Footprint|Pawprints
Forced disappearance|Abducted
Ford 335 engine|Boss 351
Ford Mustang variants|Steeda
Foreign minister|Foreign Ministry
Forensic pathology|forensic pathologist|Forensic Pathologist
Forensic photography|Forensic Photography
Forensic science|Forensic Laboratory|Forensic Services|Crime Scene Investigators
Forgetting|Forgetfulness
Former Region 3 (Johannesburg)|Region 3
Forward (association football)|IR|Inside|St|FW|CF|Attacking'|St.|ST.|Striker|IR.|Forward|Attacking
Forward pass|Pass|PASSING GAME|PASS|passing game
Fossil fuel power station|NGS
Fossil|Cast
Foul ball|foul ball|Foul Ball
Fountain square|Fountain Square
Four sights|Four Sight
Four-star rank|Four-Star|Four-star
Four-wheel drive|AWD|4x4|Four-Wheel
Fourteener|14ers|14er
Fourth Estate
Fourth grade|Year 4|Fourth-graders|fourth graders
Fourth year|Fourth Year|Fourth-year
Fox squirrel|Fox Squirrel
Frame story|Bookended
France in the long nineteenth century|19th century France|19th century French
Franchise player|FRANCHISE QUARTERBACK
Free agent|Free-agent|Free Agency|Undrafted|Undrafted Rookie|Free Agents|free agency
Free convective layer|FCL
Free education|Free Tuition|free tuition
Free market|Free Markets
Free-to-play
Freedom of speech|Free-speech|Free Speech
Freeway service patrol|Motorist Assistance Patrol|Safety Service Patrol
French fries|French Fries
French onion soup
French toast|French Toast
Freshman|First-Year|Fr.|First-year
Fried chicken restaurant
Fried chicken|Fried Chicken|fried chicken
Friending and following|Following|Follow|Friends
Friendship bench|buddy bench
Front running|Front-running
Frontage road|Access Road|Outer Road|Frontage Road
Frozen banana|Frozen Bananas|Bananas
Frozen custard|Frozen Custard
Frozen yogurt|frozen yogurt
Frying|Refried
Fuel efficiency|Fuel-efficient
Fuel tax|Gas Tax|gas tax
Fugitive|Wanted Person
Fugu|Blowfish Sushi
Fuji (apple)|Fuji
Full body scanner|Full Body
Full breakfast|American breakfast
Full moon|Hunter's Moon|Beaver Moon|Full|THE FULL
Fullback (gridiron football)|FB
Fun Dip|Fun Dips
Funding
Fundraising|Raise Money|Fundraising Campaign|raise money
Funeral potatoes|Hashbrown Casserole|hashbrown casserole
Funeral|funeral services|Funeral services
Funnel cloud|Funnel Cloud
Furniture|Home-furnishings
Furry convention|Fur Con
Fusion cuisine|Asian Fusion|Asian fusion|Asian-fusion
Futures exchange|Futures
Galácticos|Galactico
Galette|Galettes
Game (hunting)|Wild Game
Game balance|Difficulty Level
Game seven|Game Seven
Game show|Game Show
Gamemaster|GM
Gang|gang members|Gang Activity
Garbage collection (computer science)|Garbage Collection
Garbage truck|WCV
Garden centre|Garden Center|Garden Centers
Garden club|Garden Club
Gardening
Garlic bread|Garlic Bread
Gas leak|gas leak|Gas Leak
Gaslighting
Gasoline and diesel usage and pricing|Gas Prices
Gastroschisis
Gay bar|Gay Bar
Gender equality|Gender Equality
Gender variance|Gender-Nonconforming
General contractor|Construction Contractor|General Contracting|General Contractors|construction contractor
General counsel|Chief Legal Officer
General fitness training|Get Fit
General manager (American football)|GM
General manager (baseball)|general manager
General manager (basketball)|GM
General manager|GM
Generic brand|generic
Genesis creation narrative|the Created
Genetic engineering|Gene Technologies
Genetic genealogy|genetic genealogy
Genetic testing|Gene Test|DNA Testing|DNA Tests
Genetically modified organism|Non-GMO
Genetics|Genetic
Gentilly, New Orleans|Gentilly
Geophysics|Geophysical|geophysical
German nationality law|German citizens
Ghost bike|Ghost Bike|ghost bike
Giant panda|Giant Panda|Giant Pandas|Panda|giant panda
Gifford Springs, California|Gifford Springs
Gift wrapping|Gift Wrapping
Gift|Gift-giving
Ginger beer|Ginger Beer
Gingerbread|Gingerbread Cookies|Gingerbread Cookie
Girlfriend|GF
Glasses|Eyeglasses
Glissando|Fall Off
Global warming|Climate Emergency|Global Warming|global warming
Globalization|Globally
Glossary of poker terms|Dark|Chop|Final Table
Glossary of tropical cyclone terms|Potential Tropical Cyclone|potential tropical cyclone
Gluten-free diet|Gluten Free|Gluten-Free|gluten-free
Goal (ice hockey)|Goal-Scoring
Goal difference|Point Differential
Goal line (gridiron football)|Goal Line
Goalkeeper (association football)|Goal
Goaltender|Goaltending
Goat|GOAT|the GOAT
Going concern|Going-concern|going concern
Golden cownose ray|Golden Ray
Goldendoodle|Goldendoodles
Golf stroke mechanics|Putting
Golf|golfer|Scramble|Golf Tournament|scramble
Gonorrhea|STD
Googol|One Google
Goto|go to|JUMP TO
Government budget|City Budget
Government of Ukraine|Ukrainian government
Government|Gov.|Govt
Graded stakes race|Grade 1
Graduation|Graduated
Grammatical person|5th Person
Grand Slam (tennis)|Tennis Open|Grand Slam
Grand jury|grand jury|Grand Jury|Grand Jury:
Grand tourer|Gran Turismo
Granny Smith
Grant (money)|Federal Grant
Graphics processing unit|GPU|GPUs
Gravity of Earth|Earth's Gravity
Great books|Great Books
Great hall|Great Hall
Great white shark|great white shark|Great White|Shark|white sharks
Greater-than sign|More Than
Green bean casserole|Green Bean Casserole|green bean casserole
Green bean|Green Bean|green beans|Green Beans
Green vehicle|Clean Cars
Greengrocer|Produce Market
Greenway (landscape)|Open Space
Greeting card|Greeting Card
Grief|Loss|Grieving
Grievous bodily harm|Malicious Wounding
Grilled cheese|grilled cheese|Grilled Cheese
Gristmill|flour mill
Grits
Grocery store|Grocery Shopping|Grocery Store|Grocery|Grocery Stores|Grocers|grocery store|Food Store|grocery stores
Groin|Groin Injury
Gross domestic product|GDP
Gross national income|GNI
Groundbreaking|Break Ground
Gua bao|Bao Buns
Guaifenesin|Dilyn
Guard of honour|Honor Guard|Ceremonial Unit
Guestbook|Guest Book
Guide book|Travel Guides
Guide dog|guide dog
Guided missile destroyer|DDG
Gun buyback program|Gun Buy Back|Gun Buyback|gun buyback|Gun Buy-Back
Gun control|Gun-control
Gun safety|Gun Safety
Gun violence|Gun Violence Prevention|Gun Violence|gun violence
Gunshot wound|Shooting|Shot To Death
Gutter oil|Asian restaurant
Gym|The Gym
Gynaecology|Gynecologist
Hadith|Hadis
Haenyeo
Hair loss|hair loss|Hair Loss
Hairstyle|Haircuts
Half and half|Half And Half|Half and Half
Half marathon|half marathon|Half Marathon
Halftime show|Halftime Show
Hamburger|Burgers|Hamburgers™|Beef Burger
Hand injury|Hand Injury
Hand washing|Wash Your Hands|Wash your hands|wash your hands
Hand|Hand Fracture|broken hand|Broken Hand
Hand, foot, and mouth disease|HFMD
Handedness|Left-handed|Right-hander
Handicap (golf)|Handicap System
Handlebar moustache|handlebar mustache|Handlebar Mustache
Handsfree|Hand-Free|Hands-free
Handspring (gymnastics)|Back Handsprings
Happiness|The Happiest
Harbor Town, Memphis|Harbor Town
Hard candy|Boiled Sweets
Hard disk drive|HDDs
Hardcourt|Hard
Hardware store|hardware store|Hardware Shop
Has-a|Has A
Hat-trick
Hate crime|Hate Crimes|Hate Crime|hate crime|hate crimes|Bias Crimes|Hate Crime Laws
Hate group|hate group|hate groups|Hate Groups|Hate Group
Haunted attraction (simulated)|haunted attraction|Haunted House Attractions|Haunted House|haunted house
Haunted house|Haunted House
Hawaiian tropical rainforests|Hawaiian Jungle
Hazardous waste|Hazardous Waste|hazardous waste
Haze|Hazy
Head coach|HC|Coach
Head teacher|School Director|school director
Healing|Healing Process
Health campaign|Health Campaign
Health care|Health-care|Care Management Organization|Health Care|health care|Healthcare|medical care
Health club|Fitness Center|fitness center
Health crisis|Health Crisis
Health effects of wine|Health Benefits
Health policy|Health Plan
Health system|health care costs|Health System|Health Care System|Healthcare System|Healthcare Systems|health system
Health|Health Issues|Wellness|Unhealthy|Healthy|The Healthy
Healthy diet|Healthy Eating
Hearing (law)|public hearing|public hearings|Public Hearing|Public Hearings|hearing officer
Hearing loss|Hearing Loss
Heart rate|Heart Rate|heart rate
Hedge fund|Hedge|Hedge-fund|hedge funds|Hedge Funds
Heel (professional wrestling)|Heels
Height in sports|In Sports
Hello Panda
Hepatitis A|hepatitis A
Herding dog|Herding Dog
Here We Go (Steelers song)|Here we go, Steelers|@Steelers
Hermit kingdom|Hermit Kingdom
Hibachi|Hibachi Grill
Hickory Hill, Memphis|Hickory Hill
Hidden camera|Hidden Camera
High fantasy|Epic Fantasy
High school football|PREP FOOTBALL|High School Football|high school football|High School|HIGH SCHOOL FOOTBALL|Prep|prep football
High tech|High-tech
High voltage|High-Voltage
High-deductible health plan|HDHP
High-functioning autism|High-Functioning
High-heeled shoe|High Heel
High-intensity interval training|HIIT|High-intensity|High Intensity Interval Training
High-occupancy vehicle lane|HOV|transit lane|Transit Lane
High-pass filter|High-Pass Filter
High-speed rail|high-speed|High-speed|High-Speed Train|high-speed rail
Higher education|Higher Ed|Higher Education
Highway|Hwy
Hiking (sailing)|Sitting Out|sitting out
Hip replacement|Hip Surgery|hip surgery
Historic house|Historic Homes
Historic motorsport|Historics|The Historic
Historic preservation|preservationists
Historical revisionism|Rewriting History
Historical society|Historical Society|Preservation Society|historical society
History of cardiopulmonary resuscitation|CPR
History|Historic
Hold (compartment)|Cargo Holds|Cargo Space
Holdall|Gym Bag
Holotype|Based On
Home (sports)|Home Games|Home-field
Home advantage|Home Court Advantage|Home-Field Advantage
Home automation|Smart Home
Home cinema|Media Center
Home construction|home builder|Home Builder
Home improvement|Home-improvement|Home-Improvement|Remodeling|Home Renovations|Home Renovation|Home Remodeling
Home invasion|Home Invasion Robbers|Home-Invasion Robbery
Home repair|Home Repair|Home Maintenance|Home Repairs
Home run|Back-to-back|HR|home run|Homers|Home Run
Homecoming|Homecoming King
Homelessness|homeless person|homeless|homeless services|Homeless|Homeless People
Homeowner association|Homeowners Association|homeowner's association|HOA|Home Owners Associations
Homeschooling|Home-schooled
Honey bee|Honey Bees|honeybees|Honeybees
Honey bun|Honey Bun
Honeycrisp
Honour|Honoring
Hoosier
Hope chest|Hope Chest
Horchata|horchata
Horizontal bar|High Bar
Horror and terror|Horrifying
Horror film|Scary Movies|Horror Movies|Horror
Hors d'oeuvre|Appetizers
Horse-drawn vehicle|Horse-drawn
Horsepower|HP
Hospice|Hospice Care
Hospital emergency codes|Code Yellow
Hospital|Hospitalized
Hot air balloon|hot air balloon
Hot chicken|Nashville hot chicken|Nashville Hot Chicken|Hot Chicken|hot chicken|Nashville hot
Hot dog|Hot Dogs
Hot pot|Hot Pot|Sichuan Hot Pot|hot pot
Hot rod|HOT ROD|Hot Rod|hot rod
Hot sauce|pepper sauce|Hot Sauce|hot sauce|Pepper Sauce
Hot start|Hot Start
Hot tub|Hot Tub
Hotel manager|Hotel
Hotel rating|Five-Star Hotel
House of correction|House of Correction
Houseboat|House Boats
Household chemicals|Household Chemicals
Housewife|Housewives|Stay-at-Home Mom
Housing estate|Housing Complex
How Many
How-to|How to
Hub gear|Gear Hub
Hula hoop|Hula Hoop|hula hoop
Human body|Human Remains
Human hair color|Hair Color|Gray Hair
Human impact on the environment|Human Activity
Human leg|Human Legs
Human papillomavirus infection|HPV
Human physical appearance|Looks
Human resource management|Human Resource Management
Human resources|Human Resources
Human rights group|Rights group
Human rights|human rights|Human Rights|Human
Human trafficking|Anti-trafficking|human trafficking|Trafficking|Human Trafficking
Human–computer interaction|Human-Computer Interaction
Hummus
Humour|Hilariously
Humpback whale|Humpback Whale|Humpback
Hurry-up offense|No Huddle
Hydraulic fracturing|Fracking
Hydraulic rescue tools|Jaws of Life
Hydrocodone/paracetamol|Vicodin
Hypersensitivity|Hypersensitive
Hypertension|High Blood Pressure
IOS version history|iOS
Ibuprofen|Advil
Ice cave|ice caves
Ice cream cone|Ice Cream Cone
Ice cream parlor|Ice Cream Shop
Ice cream|Ice Cream|ice cream
Ice hockey statistics|Game-Winning Goal
Ice hockey|Ice
Ice house (building)|Ice House
Ice rink|Ice Rink|Skating Rink|ice skating rink|ice rink
Ice road|Ice Road
Ice skating|Ice Skating|ice skating
Icebox cake|Icebox Cake
Iconicity|Iconic
Idea|Good Idea
Identity document|ID
Identity theft|ID theft
Ignition interlock device|Ignition Interlocks
Illegal drug trade|Dealing|Drug Trafficking|Illegal Drugs
Illegal dumping|Illegal Dumping
Illegal immigration|Illegally|Illegal
Illegal sports|illegal sports|Illegal Sports
Imagawayaki|Wheel Cakes
Image (mathematics)|Image Of
Image sharing|Photo
Immediately (law)|Immediately
Immigration officer|Immigration Officers
Impact crater|Meteorite Crater
Impeachment|IMPEACH|Impeach
Improvised situation comedy|Unscripted TV
In Bed
In vitro fertilisation|IVF
Incentive program|Incentive Program
Incentive|Economic Incentives
Independence Heights, Houston|Independence Heights
Independent contractor|contractors|Contractors
Independent voter|Unaffiliated Voters
Indigenous peoples|Indigenous Peoples
Individual and political action on climate change|Climate Change Protest
Individual|Individuals
Industrial Revolution
Inequality (mathematics)|At Least
Infant mortality|Infant Mortality
Infant|Newborns|Newborn Babies
Inflatable boat|Rubber Dinghy
Influenza vaccine|Flu Shots|flu shot|Flu Shot|flu shots|Flu Vaccine
Influenza|the flu|The Flu|Flu
Information model|Information Model
Information overload|Interesting Facts
Information system|Information System Services
Information technology|Information Technology|Technology
Injury|Injured
Inline-four engine|I4
Input/output|Input Output
Insanity defense|Reason of Insanity
Insanity|Insanely
Insect bites and stings|Bug Bite
Insider trading|Insider Trading
Inspection|Safety Inspection Service
Instant mashed potatoes|Potato Flakes
Instant-runoff voting|Irv|ranked choice voting
Insurance broker|Insurance Agency
Intellectual disability|Intellectual and Developmental Disabilities
Intelligence quotient|IQ tests|IQ
Intelligent design|ID
Intention (criminal law)|Willfully
Intentional grounding|Intentional Grounding
Interception|Pick 6|INT|INTs|PICK|Pick Six|INTS
Interchange (road)|Exit
Intercom|call button
Interior design|Interior Designers|Home Decor|Home Décor|interior designers
Internal affairs (law enforcement)|Internal Affairs Division
Internal audit|Internal Auditor|internal auditor
Internet café|Internet Cafe
Internet celebrity|Influencer|influencers|Influencers
Internet forum|Moderators
Internet meme|MEMES
Interrogation|Interrogation Technique|interrogation technique
Interrogative word|Whichever
Interstellar object|Interstellar
Interstitial cystitis|Interstitial Cystitis
Interstitial lung disease|Interstitial Lung Disease
Intrauterine device|IUDs
Introduced species|Exotic
Invasive species|Invasive
Investigative journalism|Investigative Reporter|Investigative Journalism
Investment|Investment Services Inc.|Invest|Investments|Investing
Iowa–Minnesota football rivalry|Floyd|Floyd of Rosedale
Iraqi security forces
Iron Curtain
Irritable bowel syndrome|IBS
Isabella Bank
Islamic religious leaders|Muslim leader
Israeli security forces|SECURITY
Italian Market, Philadelphia|Italian Market
Italian beef|Italian beef sandwich
Italian sausage|Italian
Itamae|Sushi Chef
Izakaya
Jack-o'-lantern|Halloween Pumpkins|Jack-O-Lantern|Pumpkin Carving|Jack O' Lantern
Jacket|Jackets
Jackknifing|Jackknifed
Jalapeño popper|Jalapeño Popper
Jamaican patty|beef patties
Jameela
Japanese curry
Japanese noodles|Japanese noodle
Java (programming language)|YOLO
Jazz club|Jazz Club|jazz club
Jeep four-wheel-drive systems|Freedom Drive
Jell-O
Jelly doughnut|Jelly Filled
Jeopardy! Teen Tournament|Teen Tournament
Jet bridge|Jet Bridge|jet bridge
Jet stream|Polar Jet Stream
Jihadism|Jihadists
Job costing|Job Costing
Job fair|Career Fair|career fair|job fair
Job hunting|Job Searching|Job Seekers
Job interview|Job Interview|job interview
Joint resolution|HJR
Jonathan (apple)|Jonathan
Joule|MJ
Journalism school|Journalism School
Judicial district|Judicial District
Judiciary of Australia|Australian court
Judiciary of Texas|Texas court
Judiciary|judicial|judicial branch|Judicial
Juiced ball theory|Juiced-ball|Juiced Ball|juiced ball
Jump shot (basketball)|jump shot
Junior varsity team|JV
Junk science|Junk Science|junk science
Jus soli|birthright citizenship
Kafir|non-Muslims
Kelp forest|Kelp Forest
Kennel club|Kennel Club
Kenwood Hill, Louisville|Kenwood Hill
Ketogenic diet|the keto diet|The Keto Diet
Ketorolac|Toradol
Key lime pie|key lime pie
Keychain|Key Fob
Khurais oil field|Khurais
Kidnapping|Kidnap
Kidney stone disease|kidney stones|Kidney Stones
Kids' meal|Kids Meals
Killer whale|Orca|Orcas
Kilowatt hour|GWH|W.H.
King crab|stone crab|Stone Crab
Kings Grant, Virginia|Kings Grant
Kishka (food)|Kishka
Kitchen cabinet|Kitchen Cabinets
Knee|Knee Injury
Knockout|K-O|TKO|KO|Knocking Out
Knot (unit)|The Knot
Knowledge (legal construct)|Knowingly
Knowledge|Knows
Köppen climate classification|Climate|climate
Kouign-amann|kouign amann
Labor relations|Labor Relations
Laboratory animal sources|Buncher Co.
Laboratory|chemistry lab|Science Lab|Chemistry Lab
Labour economics|Job Market
Labour law|Labor law
Lagom
Lake-effect snow|lake-effect snow|Lake-effect|Lake Effect Snow
Lakewood Ranch, Florida|Lakewood Ranch
Lamb and mutton|Cuts of Lamb
Lance corporal|Lance Cpl
Land speed record|land speed record
Land trust|land trust|Conservation Trust
Land-grant university|Land-Grant
Landfill fire|Dump fire|Dump Fire|landfill fire
Landing gear|Landing Gear
Landing operation|Landing|Landing Beach
Landscape architecture|Landscape Architecture
Largest body part|Biggest Heart
Laser pointer|Laser Pointer
Laser printing|color laser printer
Last call (bar term)|Last Call
Last man|Last Man
Last-minute goal|Last-Minute|Last-minute
Late night television|Late-Night|Late-night
Late-night talk show|Late-night
Launch control (automotive)|Launch Control
Laundry detergent|laundry detergent
Lavash
Law enforcement|Law
Law firm|law
Law of California|California law|THE LAW|California
Law of Florida|Florida law
Lawn|Yard Work
Lawsuit|Legal Battle|legal battle
Lawyer|Attorneys|Atty
Laziness|Lazy People
Lead glass|Crystal
Lead-in|Lead In
Leadership studies|Organizational Leadership
Leading lady|Female Lead
Leaf peeping|Leaf Peepers
Leaf spring|Leaf Springs
Leaf vegetable|Leafy Green
Leaf|Alternately
Leasehold estate|Tenants
Leave (military)|On Leave|on leave
Leave of absence|leave of absence|Paid Leave|Leave Of Absence
Lees Camp, Oregon|Wilson
Left- and right-hand traffic|ON THE LEFT
Left-wing politics|left-wing
Leg press|Leg Presses|leg presses
Leg side|On Side
Legal aid|Legal Aid Service|Legal Aid
Legal case|Legal Case|Legal
Legal defense fund|Legal Defense Fund
Legal psychology|Legal
Legality of cannabis|Regulation Of Marijuana|Weed Legalization
Legalization|Legalized|Legalize
Legislator|Lawmakers
Leisure|Doing Nothing|Spare Time
Lemon law|lemon law
Lemon meringue pie|Lemon Meringue Pie
Lenders mortgage insurance|PMI
Leon Springs, Texas|Leon Springs
Leonidas, New Orleans|Leonidas
Lethality|Life-Threatening
Lethwei
Level crossing|Railway Crossing
Libido|Low Libido
Library|Libary
Lieutenant (British Army and Royal Marines)|Lt.
Lieutenant colonel (United States)|Lt. Col|Lt. Colonel
Lieutenant general (United States)|Lt. Gen
Life imprisonment|Life-Sentence
Life insurance|life insurance
Life skills|Life
Lifelong learning|Lifelong Learning
Lifesaving|Life Saving|Life-Saving|Life-saving
Light aircraft|small plane|Small Plane
Light heavyweight (MMA)|light heavyweight|Light Heavyweight
Light heavyweight|light heavyweight
Light-emitting diode|LEDs|LED
Light-on-dark color scheme|Dark Mode|dark mode
Lightning round|Lightning Round|lightning round
Lightning
Lijsttrekker|Main Candidate
Like|Liked
Limited liability company|LLC.|LLC
Line (geometry)|Straight-line
Line (ice hockey)|Linemates
Linebacker|OLB|LB|LB/DE|Linebacker Limited|MIKE
Lineman (gridiron football)|OL|Defensive Line|Offensive Lineman|offensive lineman|offensive line|Offensive Line
Linen|Linen Company
Lion|Lion Cub|African lions|African Lion|African Lions
Lip dub|LipDub
Liquid nitrogen|liquid nitrogen|Liquid Nitrogen
Liquor license|liquor license
Lisfranc injury|Lisfranc
List price|MSRP
Literacy|Read and Write
Literal and figurative language|figuratively|Figuratively
Literary award|Literary Award
Litter box|cat litter|Litter Box
Live preview|LiveView
Live television|Live TV
Liveaboard|liveaboards
Liveblogging|LIVE BLOG|Live Blog|live blog
Livelihood
Liver shot|Liver Shot
Liver transplantation|living donor liver transplantation
Living wage|Fair Wage
Lo mein|Lo Mein
Lo-fi music|Low-Fi
Loan (sports)|Loanees
Lobbying|Lobbyist
Lobster roll|Lobster Rolls
Lobster trap|Lobster Trap
Local bike shop|Bike Shop
Local board of health|board of health|Health Commissioner|Board of Health
Local election|Municipal Election|municipal election
Local food|Edible
Local government|Local
Local news|LOCAL NEWS
Local purchasing|Buy Local
Local-express lanes|express lanes
Lock (water navigation)|Locks|Lock and Dam
Locked-in syndrome|Locked-in Syndrome
Lodging|Short-Term Rentals
Loess|Loss
Long hair|Long Hair
Long run and short run|Longer Term
Long snapper|Long Snapper|long snapper
Long underwear|Long Johns
Longevity|Longest Living|Live Longer
Longhorn beetle|Long-Horned Beetles
Loon|Loons
Lorne sausage|sliced sausage
Loudness|Loudly
Loudspeaker|Speakers
Lovers' lane|Love Lane
Low-carbohydrate diet|Low-Carb|Low-carb|Low-Carb Diet
Low-density lipoprotein|LDL
Low-pressure area|Low Pressure System|Lows
Low-protein diet|Protein Diet
Lowrider
Lucha libre|Mexican Wrestling
Luck|Luckily
Lumber|2x4|2x4 board
Lunar south pole|South Pole of the moon
Lunchbox|Lunch Boxes
Lung cancer|Lung Cancer|Lung|Cancer|lung cancer
Luxury tax (sports)|CBT|Luxury
Luxury vehicle|Luxury Car
Lying in state|Lie In State
Lynching
Lysergic acid diethylamide|LSD
M
Macaroni and cheese|Mac and Cheese|mac and cheese|Macaroni & Cheese|Mac n Cheese|Mac And Cheese|Mac & Cheese|Mac 'n' cheese|macaroni and cheese|mac 'n' cheese|MACARONI & CHEESE
Magic (illusion)|Magician
Magnetic resonance imaging|MRIs|MRI
Mail and wire fraud|Wire Fraud
Mail order|Mail Order
Main Street, Letterkenny|Upper Main Street
Maize|Corn
Major general (United States)|Gen.|Maj. Gen
Major trauma|Traumatic|Injured|Injures
Malapropism|Malaprop
Malt|The Malted Barley|Malted Barley
Mammary gland|Mammaries
Mammography|Mammogram
Management|superintendent
Manager (baseball)|Managers
Managing editor|Senior Editor
Manakish|Manoushe
Manslaughter|Involuntary Manslaughter
Map|INTERACTIVE MAP
Maple Leaf, Seattle|Maple Leaf
Maple butter|Maple Butter
Marching band|marching band
Marines|Marine|marine
Marital status|Relationship Status|relationship status
Market (economics)|The Market
Market rate|Market-rate
Market research|Market
Marketing buzz|Buzz
Marketing|Marketing Co.
Marriage|Tying the Knot|Marry|Married
Martial arts|martial arts
Martin Drive, Milwaukee|Martin Drive
Maserati in motorsport|Maserati
Mashed potato|Mashed Potatoes|Mashed Potato|Smashed Potatoes|mashed potatoes|smashed potatoes
Masquerade ball|Masquerade Ball
Mass grave|mass grave
Mass surveillance|Surveillance Program
Massachusetts Avenue, Indianapolis|Mass Ave
Massage parlor|Massage Parlors|Massage Parlor
Massage|Massage Therapist
Matcha
Materials recovery facility|Materials Recovery
Maternal insult|Your mother|Your Mother
Mathematics|MATH|Math|math
Matryoshka doll|Russian nesting doll
Maxima and minima|Maximize
Mayor|City Mayor
McIntosh (apple)|McIntosh
Meadowview, Sacramento, California|Meadowview
Meanings of minor planet names: 11001–12000|Easterwood
Meanings of minor planet names: 15001–16000|DiSanti
Meat analogue|Faux Meat
Meat packing industry|Meat Packers
Media of Russia|Russian media
Media relations|Media Relations
Media studies|Media Studies
Medial collateral ligament|MCL
Median arcuate ligament syndrome|Median Arcuate Ligament Syndrome
Medical cannabis|MEDICAL MARIJUANA|Medical Marijuana|Medical Purpose|medical marijuana|Medicinal
Medical debt|medical debt|Medical Debt
Medical device|Medical Supplies|medical supplies|medical devices
Medical examiner|Medical Examiners
Medical record|medical records
Medical sign|Signs & Symptoms
Medical test|Medical Tests
Medicine|Medical|Medical Practice|Healing Arts
Medley swimming|individual medley
Megalodon|Megalodon Shark
Melrose (apple)|Melrose
Men's 110 metres hurdles world record progression|In The|in the
Meningococcal disease|Meningococcal Disease|meningococcal disease
Mental disorder|mental|mental illness|Mental Illness|Mental|BREAKS DOWN|Mental Health Problems
Mental health court|Mental Health Court
Mental health|mental health services|mental health|Mental Health|Behavioral Health|Mental health services|Mental Health Services|Mental|Mental-health|behavioral health
Menu extra|Menu Items
Menu|Secret Menu
Merchandising|Merchandise
Mergers and acquisitions|Merger of Equals|M&A
Message passing|Message-Based
Metal foam|Metal Foam
Meteor shower|Meteor Shower|meteor showers|Meteor Showers
Meteoroid|meteor|Meteor
Meteorology|Meteorologists|Meteorologist
Metered-dose inhaler|Asthma Inhalers
Methamphetamine|Crystal Meth
Metres above sea level|ASL
Metropolitan borough|Metropolitan District
Mexican free-tailed bat|Mexican free-tailed bats
Mezcal
Microbrewery|Brew Pub|Craft Beer
Microcredit|Microloans
Microphone gaffe|Hot Mic|hot mic
Microplastics
Mid-range|Mid-Range
Middle East, Baltimore|East Baltimore
Middle class|middle class
Middle mile|Middle Mile
Middle school|middle schools|Middle School|middle school|Middle Schools|Middle School Student|Junior High School|Intermediate School
Middleweight|Middleweight Champion
Midfielder|LW|DM|WH|Md|LB|WG|Wings
Midtown Farmers' Market|Midtown Farmers Market
Mile high club|Mile High Club
Milestone|Mile Marker
Military aid|Military Aid|military aid
Military designation of days and hours|T-Day
Military exercise|Maritime Exercise
Military rank|Temporary
Military reserve force|Reserves
Military uniform|Uniforms
Military|Service|defense|Military Force
Mill District, Minneapolis|Mill District
Millionaire|Million-Dollar
Milwaukee metropolitan area|Milwaukee-area|Milwaukee area
Miniature horse|Mini Horse|miniature horses|Miniature Horses
Minimum wage|Minimum Wage
Mining|The Mining
Minion (cannon)|Minion
Minority leader|leader|Leader
Minority-serving institution|Minority Serving Institutions
Miscarriage of justice|Wrongful Conviction
Mischief|criminal mischief
Missing in action|missing in action
Missing person|Missing Children
Mississippi Attorney General|Attorney General
Mistake (contract law)|Common Mistakes
Mitochondrial disease|Mitochondrial Disease
Mixed martial arts|MMA
Mobile app|App|app
Mobile home|mobile home community|Mobile Home|Mobile Home Community|mobile home
Mobile phone|Cellphone video|Cellphone
Mock draft|mock draft|Mock Draft
Models of scientific inquiry|Scientific Explanation
Modern history|Modern Era
Modernism|Modernist
Modesty|Modest
Molasses|Blackstrap
Molecular gastronomy|Molecular Gastronomy
Moment of silence|Moment Of Silence|moment of silence
Monarch butterfly|Monarch
Monster movie|Movie Monster
Montreal-style bagel|Montreal-style
Mood swing|Mood Swings
Moral responsibility|Responsibility
Moria (tree)|Moria
Morning glory|Morning Glory
Morris dance|NW.
Mortgage loan|home loans|Mortgage|mortgage
Mother|Mothers-to-be
Motion detector|Motion-sensor
Motion of no confidence|No Confidence|no confidence
Motocross|MX
Motor vehicle theft|Car Thief|Car Thieves|Stolen|Stolen Vehicle|car thief
Motorcycle club|motorcycle club|Motorcycle Club
Motorcycle helmet|Motorcycle Helmet|motorcycle helmet
Motorcycle|Bikes
Motorcycling|Motorcyclists
Motorized scooter|E-scooters|E-Scooters|E-scooter
Moving average crossover|Slower
Mug shot|booking photo
Mulard|Moulard
Mulled wine|Mulled Wine
Mullet (haircut)|Mullet Haircut|mullet haircut
Multichannel television sound|BTSC
Multiplayer online battle arena|MOBA
Multiplayer video game|2 Players
Multiple sclerosis|Multiple Sclerosis|multiple sclerosis
Multiple-camera setup|Multiple
Multiple-vehicle collision|Multi|Chain Reaction Crash
Multiracial|Multi-racial|Mixed-race
Mumbo sauce|Mambo Sauce
Mummy|Mummification
Municipal authority (Pennsylvania)|Authorities|Municipal Authority
Municipal clerk|city clerk|City Clerk
Murder|2nd Degree Murder
Murder–suicide|Murder-suicide
Murray cod
Muscle car|American Muscle Cars|Muscle Cars
Museum|History Museum
Mushroom|Shroom
Music criticism|Critically
Music director|Band Director
Music download|Download
Music recording certification|Diamond|Gold Status|Multi-platinum|Platinum-certified
Music venue|Live Music Venue
Music video|Music Videos
Musical film|Musical Film
Musical guest|Musical Guest|musical guest
Musical theatre|Musical|Music Theatre
Musician|Musicians
Mustard seed|Mustard Seed
Mutual fund|Mutual Funds|mutual funds
Muumuu|MooMoo
Myocardial infarction|Heart Attack|heart attack
Mystery meat navigation|CLICK HERE
NBA high school draftees|None
NCAA basketball tournament selection process|selection committee|Selection Sunday
NW postcode area|NW1
Nachos|Nacho Cheese
Nail polish|Nail Polish|nail polish
Nail salon|Nail Salon|nail salon
Naloxone|Narcan
Names of the days of the week|SUN MON TUE WED THU FRI SAT
Naproxen|Aleve
Narcissism|Narcissists
Nasal irrigation|neti pot
Nation|Nationally|nationally
National anthem|National Anthem
National park|National Park|national parks
National security|National Security
Natural disaster|Natural Disasters|Disaster
Natural gas|LNG
Natural resource|Natural Resources|Resources
Natural selection|Selected For
Natural wine|Natural Wines
Nature park|Nature Park
Nature reserve|Wildlife Refuge|Nature Reserve|Nature Preserve|Natural Preserve|nature preserve|Park Reserve
Naval boarding|Cutting Out
Navel|Belly Buttons
Navigation|Navigate
Neals Diggins, California|Adams Morgan Bar
Neanderthal|Neanderthals
Neapolitan pizza|Neapolitan
Near-close vowel|Near High
Necessity and sufficiency|Necessary & Sufficient
Neck pain|Neck Pain|neck pain
Need to know|Needs to Know|Needs To Know
Need|Unnecessary
Negligence|Negligent
Negligent homicide|negligent homicide
Neighborhood association|Neighborhood Association
Neo-Nazism|neo-Nazi group|Neo-Nazi|Neo-Nazis|neo-Nazi
Neophobia|Picky Eaters
Nettop|mini-PC
Neuroimaging|Brain-scanning
Neuropathic pain|Neuropathic Pain
Neurosurgery|Brain Surgery|Brain Surgeries
Neutron|N0
New Fire ceremony|New Fires
New Hampshire native
New Year|New Years|new year
New York City Fire Commissioner|FDNY Commissioner
New York-style pizza|New York Style|New York-style
News agency|NNA|Press Agency
News analytics|News Analysis
News bureau|Bureau Chief
News conference|Press Conference|press conference|News Conference|news conference
News presenter|Anchors
Newsletter|Newsletters Company
Newspaper|Daily|Daily Paper
Nice guy|Nice Guy|The Nice Guy
Nicotinamide adenine dinucleotide|NAD
Nidhi
Nigger|N-Word|N-word
Nightclub|Nightclubs
No More (1944 song)|No more
No contest (combat sports)|No Contest
Noise-cancelling headphones|Noise-Canceling Headphones
Non-Hodgkin lymphoma|non-Hodgkin's Lymphoma|non-Hodgkin
Non-denominated postage|Forever Stamp|Forever|USPS Forever
Non-governmental organization|NGOs|NGO
Non-voting members of the United States House of Representatives|Delegate
Nonprofit organization|Non-profit organization
North Admiral, Seattle|North Admiral|Admiral District
Northwest (Vietnam)|Northwest
Not Just You
Not out|Not Out
Nouveau roman|New Novel|new novel
Nuclear power|Nuclear
Nuclear weapon|Nuclear Weapons|Bomb
Nursing home care|nursing homes|Nursing Homes|nursing home|Nursing Home
Nursing|Nurses
Nutella
Nutrition facts label|Nutrition Label|Nutrition Facts
Nutritional yeast|Nutritional Yeast|nutritional yeast
O'Donnell Heights, Baltimore|O'Donnell Heights
OK Go (album)|What To Do|What to Do|what to do
Oak (wine)|Oak Barrel|barrique|Barrique
Oasis|Oases
Objectivity (philosophy)|Objectively
Observation deck|Observation Deck
Obsessive–compulsive disorder|OCD
Obsolescence|Obsoletely
Occupational burnout|Burnout
Occupational safety and health
Ocean acidification|ocean acidification
Oceanic climate|CFB
Odds|Betting Odds
Off-road vehicle|Off-Roader
Offensive coordinator|offensive coordinator|OC
Offer sheet|Offer Sheet
Office|Class A office|The Offices|Office Design
Oil refinery|Refinery|Oil Refinery
Oil spill|Oil
Old Fashioned glass|Whiskey Glass
Old Oaken Bucket
Old World
Old age|Seniors|Elders
Old-growth forest|old-growth forests
Old-school hip hop|Old-school
Olive oil|Olive Oil|Extra Virgin Olive Oil|olive oil|Olive
Olympic-size swimming pool|Olympic-size
On s'est aimé à cause|A Cause'
On-base plus slugging|OPS
Oncology|Cancer Care
One size fits all|One-size-fits-all
One true church|One True Church
One-hit wonder|one-hit wonder|One-Hit Wonder
One-piece swimsuit|One-piece
Ongoing series|Ongoing
Onion ring|Onion Rings
Online and offline|Off Power
Online auction|Online Auction
Online gambling|Bovada
Online music store|Digital-Only
Online petition|Petition
Online shopping|Online Shopping|shopping online
Open hearth furnace|Open-Hearth
Open mic|Open Mic Night
Open space reserve|Open Space
Opening Day|Home Opener|home opener|season opener|Season Opener
Opening statement|Opening Statements|Opening Arguments|Opening Statement|Opening statements
Opera house|Opera House
Opera
Operating cost|Operating costs
Ophthalmology|Eye Doctor|eye doctor
Opinion journalism|Opinion Writer
Opinion poll|Poll|Public Opinion Research|Polls
Opioid overdose|Opioid Overdose
Opioid use disorder|ORT|opioid addiction|Opioid Addiction
Opportunism|Take Advantage
Opportunity cost|Cost|Hidden Cost|Hidden Costs
Opposition to immigration|Anti-immigrant
Optical illusion|Optical Illusions|optical illusions
Option style|European-style
Orange Mound, Memphis|Orange Mound
Orchard|Fruit Farms
Order of succession|Palace Intrigue
Orders of magnitude (length)|10nm|1 FM
Organ donation|Kidney Donor|organ donation
Organ transplantation|Organ
Orgasm|Sexual Gratification
Orphan|Orphaned
Oryx
Osteoporosis|Risk Factors for Osteoporosis
Osteria
Otorhinolaryngology|ENT
Out of the box (feature)|OTs
Outdoor cinema|Outdoor Movie
Outdoor recreation|Outdoor Recreation
Outfielder|of
Outline of health sciences|Health Science
Over-the-counter drug|OTC
Overhead camshaft|OHC|SOHC
Overselling|Overbooked
Overtime (ice hockey)|OTL|OT
Overtime (sports)|2OT|Kansas playoff
Overview of gun laws by nation|Possession of Firearms|Possession of Firearm
Over–under|Over Under
Own goal|O.G.
Owner's manual|Owner's Manual
Owner-occupancy|home buyer
Ownership|Co-owner
Oxycodone|OxyContin
Oyster bar|Oyster Bar|oyster bar
Oyster|Oyster Co.|Oyster Company
Oysters Rockefeller|Rockefeller
Ozone depletion|Antarctic ozone hole
Pad thai|Pad Thai
Pain management|Pain Management
Paint sheen|Gloss Paint
Pale ale|Ale|pale ale|Pale Ale
Palestinian political violence|Violence|Palestinian militants
Palm oil|palm|Palm
Pan pizza|Pan Pizza
Pancreatic cancer|Pancreatic Cancer
Panic attack|Panic Attacks
Paracetamol|Acetaminophen
Paramount chief|Paramount Chief
Paranormal|paranormal
Parent company|Parent Organization
Parent|Parents|Parental
Parental leave|paternity list
Parenting styles|Parenting Style
Parenting|Parenthood
Park Hill, Denver|Park Hill
Park and ride|Park & Ride|Park And Ride|Park and Ride
Parking space|Parking Spot
Parks of Milwaukee|Pere Marquette Park|Milwaukee County Parks
Parkway Village, Memphis|Parkway Village
Parole board|Board of Pardons and Paroles|Parole Board
Parsley|Italian parsley
Part-time contract|Side Hustle|side hustle
Participatory budgeting|Participatory Budgeting|PB
Partner (business rank)|managing partner
Party chair|Party Chairwoman
Party platform|Election Platform
Pass interference|pass interference
Passer rating|Passer Rating|QB rating
Passive house
Pasta e fagioli|pasta fagioli|Pasta Fagioli
Pastry chef|Pastry Chef
Patch (computing)|software update
Patio heater|patio heater
Patty melt|Patty Melt
Patty|Sausage Patties|sausage patties
Pay television|Pay|Pay TV|pay-TV
Payment system|Payment System
Pea soup|split pea soup
Peanut butter and jelly sandwich|Peanut Butter Sandwich|PB&J
Peanut butter cookie|Peanut Butter Cookies
Peanut butter cup|Peanut Butter Cup
Peanut butter|PB.|peanut butter|Peanut Butter
Peanut punch|Peanut Punch
Peanut|Spanish Peanut Co.
Pecan pie|Pecan Pie
Pedestrian
Pediatrics|Pediatrician|Pediatric
Peer support|Peer Support
Penalty box|Penalty Box
Penalty shoot-out (association football)|P
Pencil skirt|Pencil Skirt|pencil skirt
Penicillin|Allergic To Penicillin
Penny stock|penny stocks|Stocks|Penny Stocks
Penny war|Penny War
Pension fund|Pension Fund
Pensioner|Retirees|retirees
Pep rally|Prep Rally|Rally
Peppermint bark|Peppermint Bark|peppermint bark
Perfect game|Perfect Game|Perfect
Perfect season|near perfect|Near Perfect|Undefeated Season
Perfluorononanoic acid|PFNA
Performance studies|Performance Study
Performance-enhancing substance|Performance Enhancing
Performing arts center|Performing Arts Center
Periodic table|periodic table
Peripheral artery disease|PAD
Perkins Homes, Baltimore|Perkins Homes
Permanent residency|permanent residence
Perpetual war|Endless Wars
Person of color|Woman of Color|Girls of Color
Person of interest|Persons-of-interest
Personal boundaries|Set Boundaries
Personal computer|PCs|PC
Personal finance|Personal-finance
Personal flotation device|Life Jackets
Personal injury|Personal Injury
Personal life|Living
Personal message|Personal Message
Personal stylist|Personal Stylist
Personal trainer|Trainers|Fitness Trainers|Personal Training
Personality type|Personality Type
Pest control|Pest Control
Pet adoption|pet adoption|Forever Home|Pet Rescue|Adoptions|Pet of the Week|Forever Homes|Adoption|Pet Of The Week|Rehoming|Animal Rescue|Rescue Dogs|Adopting a Dog|Rescue Dog
Pet peeve|Pet Peeves
Petroleum industry|Oil and Gas|Oil Patch
Petroleum reservoir|oil fields|Oil Fields
Petroleum|Oil|Petroleum Company
Phantom power|48V
Pharmaceutical industry|Pharmaceutical
Phase-out of lightweight plastic bags|plastic bag ban|Bring Your Own
Phases of clinical research
Phishing
Phoenix metropolitan area arterial roads|Mill Avenue|Indian School Road|Camelback Road
Phone fraud|Phone Scam|phone scam
Phonograph record|Records
Photo manipulation|Photoshopping|Photoshopped
Photo shoot|Photo Shoot|photo shoot
Photography|Photographers
Physical strength|Arm strength
Physical therapy|Physical Therapists|Physical Therapist
Phytophthora ramorum|Sudden Oak Death
Picketing|Picket Line|picket line
Pickled cucumber|Pickle
Pickup truck|pickup truck|Pickup Truck|full-size pickup|Pickup|Pickup Trucks|Full-Size Pickup
Pig farming|Pig Farm
Pilot experiment|Pilot Program|pilot program|Pilot Project
Pinch District, Memphis|Pinch District
Piney Mountain, Virginia|Piney Mountain
Pink peppercorn|Pink Peppercorn
Pipeline transport|gas pipeline|Gas Pipeline
Piri piri|Peri Peri
Pitcher|LHP|RHP
Pixie cut|pixie cut
Pizza cutter|Pizza Cutter
Pizza|Pizza Shop|pizza places|Pizzeria|Pizza Places|Pizzerias
Placekicker|Kicker
Plane (Unicode)|Plane One
Planned community|Planned
Plant|Plants
Plantation economy|Plantation-based
Plastic recycling|Recycled Plastic
Plastic surgery|Plastic Surgery|plastic surgery|plastic surgeon
Plat|Plan
Platform game|Running Game
Play (theatre)|Play
Play calling system|Play-calling
Play-action pass|play-action
Player character|Game Character|Playable
Player of the match|player of the game|Player of the Game
Player positions (paintball)|Player Position
Player versus environment|PvE
Player versus player|PvP
Playing time (cricket)|Playing Time
Playoffs|Playoff Games|Playoff|Playoff Game|playoff|The Playoffs
Plea bargain|plea deal|Plea Deal
Plea|plead guilty|Plead Guilty
Plug-in hybrid|Plug-In Hybrid
Pluggers
Plumbing
Po' boy|Po-Boy|Po' Boy|po-boy
Pocket dialing|Pocket-dialing
Pocket-Greenhaven, Sacramento, California|Pocket
Point (basketball)|Points Scored|Points|Scoring|points
Point (typography)|The 12-point
Point guard|Point Guard|PG
Point of sale|CHECK OUT|Checkout Lanes
Point-to-point construction|dead bug
Points of the compass|SW|WNW
Points per game|PPG
Polar High|Arctic high pressure
Pole position|Pole sitter
Police accountability|Police Accountability
Police board
Police brutality|Police Brutality
Police car|Police Cruiser|Police Car|patrol car|Patrol Car
Police dog|K-9|Police K-9|K-9 Unit|Dog|K-9 Units|K9|K9 Unit|Canine|K9 Units
Police lineup|Show Up
Police motorcycle|Police
Police officer|Police|Cops
Police|Police Department|City police
Political action committee|PACs|PAC|Political Action Committee|Super PAC|SuperPAC
Political campaign|Campaign Rally|Political Campaign
Political economy|Political Economics
Political science|Political|Political Analyst
Polling place|Polling Place
Poly(methyl methacrylate)|Plexiglas
Polycystic ovary syndrome|PCOS
Polyethylene terephthalate|PET
Polyvinyl chloride|PVC
Pony car|Pony
Poor posture|Bad Posture
Pop-up retail|Halloween Store
Pop-up satellite archival tag|PSATs
Pope|Papal
Population decline|Population Decline|population decline
Porch collapse|Balcony Collapse
Pork belly|Pork Belly
Pork chop|Pork Chop|Pork Chops|pork chops
Pork ribs|Ribs
Pork tenderloin sandwich|Pork Tenderloin Sandwich
Port of entry|Port of Entry
Portuguese sweet bread|Hawaiian Rolls
Positional advantage|Tactical Advantage Co.
Post box|Post Box
Post office|Post Office
Post-anesthesia care unit|Recovery Room
Post-credits scene
Post-game show|Post Game|Post-Game|Postgame|Post-game
Post-tropical cyclone|Post Tropical Cyclone|Post-Tropical
Postal Index Number|PIN
Posttraumatic stress disorder|Post-Traumatic Stress Disorder|PTSD
Pot roast|Pot Roast|pot roast
Potato chip|Salt & Vinegar|Potato Chips|potato chips
Pound cake|pound cake|Pound Cake
Poverty threshold|poverty line
Poverty|Low-Income|Low-income
Powder Valley, Pennsylvania|Powder Valley
Power outage|Blackout|Outages|Power Outage|Power Outages|Power Cuts|power outage|power outages
Power play (sporting term)|power play
Power-to-weight ratio|Power-to-weight
Powered exoskeleton|Exoskeleton
Powerlifting
Powers Park, Georgia|Powers Park
Practical effect|On Set
Practice of law|Practicing
Pre-game show|pre-Games
Pre-kindergarten|Pre-K|pre-K
Preadolescence|Pre-teen
Precedent|court decision
Prediction|Predicted
Pregnancy|Pregnant Woman|Pregnant|Pregnant Women|pregnant women|pregnant woman
Prenatal development|Unborn Baby
Prenuptial agreement|Prenup
Prepositional pronoun|at Him
Prescription costs|Prescription Costs
President (corporate title)|President/CEO|Team President|Company President
Presidential system|Presidential
Preterm birth|Premature Newborn|Premature Baby|Premature
Preventive healthcare|Preventing|Prevention
Price gouging|Price Gouging
Price look-up code|PLU
Priesthood in the Catholic Church|Priest|Priests
Primary care|primary care
Primary school|Elementary|Elementary School|School
Prime minister|Prime Minister
Printer's Row, Chicago|Printers Row
Prison officer|Corrections Officer|Officer|corrections officer|Corrections Officers|corrections officers
Prison uniform|Prison Uniform
Prison|Jail|Correctional Center|Detention Center|correctional facility|Correctional Facility|City Jail|Correctional Institute|Detention Facility
Prisoner exchange|Spy Swap
Private school|Non-Public|Private
Privately held company|Private
Pro tempore|Pro-Tem|Mayor Pro Tem
Probate court|Probate Court
Problem solving|Problem-solving
Process (computing)|The Process
Product recall|Food Recalls|Recall|Recalls
Production manager (theatre)|Production Manager
Productivity software|Productivity
Professional development|Professional Development
Professional organizing|Professional Organizer
Professional sports|Pro Sports
Professional student|Professional Students
Professional wrestling championship|Championship Title|Title
Professional wrestling match types|Six-Pack Challenge|Falls Count Anywhere
Professor
Profit warning|Profit Warning
Prohibition|Prohibition-era
Projection screen|projector screen
Promoter (entertainment)|Promoting
Proof (truth)|Proving
Propane|Propane Tanks|propane tanks
Propeller|Boat Propeller
Property management|Property Management
Property tax|property tax|property taxes|Property Tax|Property Taxes
Prosecutor|Prosecutor's Office|Criminal Prosecution|prosecutor's office|Prosecutor's office|Prosecution
Prospective aspect|Will Have Limited|Will Have|Would Have
Prostate cancer|Prostate Cancer
Prosthesis|Prosthetic Arm|Prosthetic Leg|prosthetic leg
Proteasome|11s
Protected area|Wildlife Area
Protectionism|Protective Services
Protein bar|Protein Bar
Protocol implementation conformance statement|PICS
Psychiatry|Psychiatric
Psychological manipulation|Emotional Manipulation
Psychological trauma|Mental Scar
Ptitim|baked pasta
Pub crawl|Pub Crawl
Pub|Public House
Public defender|public defender|Public Defender
Public health|Health|Public|Public Health|public health
Public housing|housing authority|The Housing Authority
Public lecture|Lecture Series|lecture series
Public library|Public Library
Public policy|public policy|Policy|Public Policy
Public relations|Meet & Greet|Public Relations|P.R.
Public security|Public Safety|public safety
Public transport|Mass Transit|mass transit
Public trust|Public Trust
Public utility|Publicly Owned Utility|publicly owned utility|Public Utilities|Utilities|Utility
Public–private partnership|Public-Private Partnership
Puff pastry|Puff Pastry
Pumping station|Lift Station|pumping station
Pumpkin pie|pumpkin pie|Pumpkin Pie
Pumpkin seed|pumpkin seeds|Pumpkin Seeds
Pupusa|Pupusas
Purebred dog|'PR
Putout|Put Out
Quadruplex videotape|Quadraplex
Quaker Hill, Connecticut|Quaker Hill
Quality start|Tough Loss
Quality-adjusted life year|QALY
Quantity|Amount
Quantum dot display|QLED
Quarry|Stone Quarry|Rock Quarry
Quarterback|QB|QBs|BB|QB.
Question|questionable
Quid pro quo|Quid|Quid Pro Quo|quid|quid pro quo
Quinquennial visit ad limina|ad limina
Rabies|Rabid
Race (human categorization)|Racial|racially|Racially
Race track|Race Track
Racing video game|Racing
Racism in association football|racist abuse|Racist Abuse
Racism|Racist|racist|Racially Charged|Racially-Charged
Radio broadcasting|Radio Stations
Radio drama|Radio Play
Radio-controlled car|Radio-controlled
Raffle|50/50 Raffle
Rail trail|Rail Trail|rail trail
Rail transport modelling|Model Train
Rail transport|Railroad Company
Rail yard|Railyards
Railway electrification system|Electric Operations
Rain and snow mixed|Wintry Mix
Rain tyre|WET WEATHER
Rain|Rainy|Rainfall|Rains
Rainier Valley, Seattle|Martin Luther King Jr. Way
Rainy day fund|Rainy-Day Fund
Rally towel|Rally Towel
Ramapo Valley County Reservation
Ramen|Ramen Noodles
Ramp-up|Ramp Up
Ranally city rating system|Other Cities|Examples
Random act of kindness|Random Act of Kindness
Ranitidine|Zantac|ranitidine
Ranking member|Ranking Member
Rapid transit|Rapid Transit Line|Line|Subway Train|Rapid Transit|subway train
Rapping|Rapper|rapper|Rappers|Raps
Rash|Skin Rashes
Rat|Rat-eating
Raw data|Raw Data
Reader (academic rank)|Readers
Reading (legislature)|Passed
Real estate appraisal|Home Prices|Home Value
Real estate entrepreneur|Real Estate Investors
Real estate investing|Real Estate Investment
Reality television|Reality TV|Reality|Reality Shows|reality-TV
Rear-end collision|Rear-Ended
Rear-view mirror|Rearview Mirror
Reasonable person|Reasonable-man
Rebound (basketball)|Offensive Rebounds
Recall (memory)|Remembered
Reclaimed lumber|reclaimed wood
Reclaimed water|Water Reclamation Plant
Record producer|production|Production|Producers
Recorder of deeds|County Recorder|Recorder's Office
Recreation|Recreation Centers|Recreation Center|recreation center
Recreational drug use|Recreational|Doing Drugs
Recreational vehicle|RV|RVs
Rectus abdominis muscle|Ripped Abs|Six-Pack Abs
Recycling|Recycle
Red Delicious|Red Delicious apples
Red carpet fashion|red carpet|Red Carpet Fashion|Red Carpet
Red carpet|Red Carpet
Red light camera|Red Light Cameras|Red Light Camera
Red tide|red tide|Red
Red velvet cake|Red Velvet Cake|red velvet cake
Red zone (gridiron football)|red zone
Redistricting commission|Redistricting Commission
Reef|Rock Bar
Referee (professional wrestling)|Officials
Referee|sports official
Reference range|Standard Range
Refinancing|Refinance
Reflection (physics)|Shiny
Reflexive pronoun|Itself|Herself
Refrigerator|meat locker|Meat Locker
Refugee camp|refugee camp
Rehabilitation (penology)|Rehabilitation Program
Rehearsal dinner|Rehearsal Dinner
Relational aggression|Abusive Relationship|abusive relationship
Relative direction|Right side|left side
Relief pitcher|Relieved|Relievers
Religious ecstasy|Ecstatic
Relocation of professional sports teams|Relocating|Relocate
Remake|Movie Remakes
Remembrance poppy|Poppies|Poppy
Rename (computing)|Rename
Renminbi|Chinese money
Repertory theatre|Repertory Theatre
Report card|report card|Report Card
Representative democracy|Democratic Representative
Reproductive health|sexual and reproductive health|Sexual and Reproductive Health
Research and development|R&D
Research institute|Research Institute|research institute
Research|Study|Researchers
Residency (medicine)|Residents
Residential area|Residential|residential|Residential Area
Resignation|Resigns
Resort fee|resort fees|Resort Fees
Rest area|service area
Restaurant management|Restaurant Owners|Restaurant Owner
Restaurant|Eatery
Restricted free agent|qualifying offer|Qualifying Offer|Qualifying Offers
Résumé
Retail|Stores|Specialty Retail|Shop|store|Shops|Store
Retirement age|Retirement Age
Retirement community|Retirement Community
Retirement home|Retirement Home|Senior Housing|Old Home|senior housing
Retirement savings account|retirement savings
Retirement|retire|Retire
Reveal (narrative)|The Big Reveal
Rh blood group system|RH
Rib fracture|Broken Ribs
Ribosome|70s
Rice Krispies Treats|Rice Krispie Treats
Rice and beans|Rice and Beans|rice and beans
Rice cake|Rice Cakes
Rice noodle roll|Rice Noodle Rolls
Rice noodles|Rice Noodle
Rice pudding|Rice Pudding
Rickrolling|Rick Roll
Ride-along|Ridealong
Right to counsel|Right to Counsel
Right to keep and bear arms|Gun Rights
Right to life|Right to Life
Right-wing politics|Right-wing
Rimshot (broadcasting)|Move-ins
Riot police
Riot|Rioted
Risk assessment|Human Health Risk Assessment
Risk factor|Risk
Risperidone|Risperdal
Rivet|Riveter
Road (sports)|Visitor
Road bicycle racing|Road|The Road
Road racing|road course
Road to ...|Road To
Road traffic safety|Highway Safety|Road Safety|road safety
Road trip|Road Trip|Road Trips|road trip
Road|Road Conditions|Roads|drive|Road Condition|Drive
Roast beef|Roast Beef
Roasting|Roasted
Robbery|armed robberies|armed robbery|Armed Robber|Armed Robbery|Armed Robberies
Robotic vacuum cleaner|Eufy|robot vacuum
Role-playing video game|RPGs|Japanese role-playing|RPG
Rollatini|Eggplant Rollatini
Roller coaster|Roller Coaster|Roller-coaster
Romance (love)|Love Affair
Romantic comedy|Rom-com|romantic comedies|Romantic Comedies
Rope|Ropes
Rosarigasino|Gase
Rosedale, Austin, Texas|Rosedale, Austin|Rosedale
Rotary dial|rotary phone
Rough cut|Rough Cut
Roundabout|Traffic Circle
Roux|Brown Roux
Royal William rose|Royal
Royal forest|Forest Court
Royal jelly|Royal Jelly|Royal
Ruby slippers|The Ruby Slippers
Rugby union positions|Lock|Prop
Rugby union|Rugby team
Ruins|Ruin
Rule 5 draft|Rule 5 Draft|Rule-5
Rule of law|Rule of Law
Run (baseball)|Runs
Run batted in|RBIs|RBI
Runaway (dependent)|ran away|Ran Away
Rural area|Rural
Rural district|Council District
Russian dressing
Rye bread|Rye|rye
SE postcode area|SE1
SW postcode area|SW1
Sadness|Sadly
Safe deposit box|safe deposit
Safe harbor (law)|safe harbor|Safe Harbor
Safety (gridiron football position)|Safety Position
Safety car|Pace Car|pace car
Safety|Safely
Sailor sandwich|New York Deli
Saint Louis encephalitis|St. Louis encephalitis|St. Louis encephalitis virus|St. Louis Encephalitis|St. Louis Encephalitis Virus
Saint|The Saints
Salary|annual salary
Sales|Salespeople
Salisbury steak|Salisbury Steak
Salt evaporation pond|Salt Ponds
Salt|table salt|Table Salt
Sampling (music)|Sample
Sanitary sewer|Sewer Pipe
Santa Anita, California|Santa Anita
Santiago Canyon, California|Santiago Canyon
Satellite television|Satellite TV
Satellite|Space Satellite
Sauce|Cream Sauce
Sausage gravy|Sausage Gravy
Sausage sandwich|Sausage Sandwich|sausage sandwich
Sausage|smoked sausage
Saving
Sawed-off shotgun|Boomstick
Say When (musical)|Say When
Scampi|Shrimp Scampi
Scenic design|Scenic
Scholar-official|Officials
School bus|School Buses|school bus|School Bus|school buses
School choice|SCHOOL CHOICE|school choice
School district|school districts|School Districts|School District|the district|School, Inc.|school district
School holiday|fall break
School resource officer|School Resource Officer|School Resource Officers|school resource officer|SRO
School shooting|School Shootings|School Shooting|School shootings
School|Scool
Schools for the deaf|Schools for the Deaf
Science fair|SCIENCE FAIR|science fair
Science festival|Science Festival|science festival
Science fiction film|Sci-fi
Science museum|Science Center
Scientific journal|Scientific Journal
Scientific method|Scientifically Proven
Scientific theory|Scientific Theory
Scrambled eggs|Scrambled Eggs
Screen protector|screen protector
Script (comics)|Marvel-style
Scuba diving|Scuba Diving|scuba diver|scuba diving|Scuba Diver
Sea salt|sea salt|Sea Salt
Search algorithm|Search Algorithm
Search warrant|SW|Search Warrant
Seaside resort|Beach Resort
Season (sports)|The Season|football season|Football Season|Offseason|offseason
Season|All Season|Seasonal
Seasonal affective disorder|Seasonal Affective Disorder
Second Ward, Houston|Second Ward
Second baseman|2B|Second-base
Second lieutenant|2nd Lt
Second year|Second-year
Secondary school|High Schoolers|Senior High|Senior High School|High school|High School|High Schooler|School|high school
Secret ingredient|Secret Sauce
Security (finance)|Debt Securities
Security community|Security Community
Security guard|Security Guard|security guard
Security hacker|Hackers|hackers
Self-acceptance|Self-Acceptance
Self-care|Self-Care
Self-checkout|self-checkout
Self-employment|Self-Employed
Self-service laundry|Laundromat
Self-sustainability|Self-sufficient|economic self-sufficiency
Semi-trailer truck|tractor trailers|Tractor Trailer|semitruck|Semi|Semitruck|Semi-truck|tractor trailer|Tractor-trailer|Tractor Trailers
Senior (education)|SR|Sr|Sr.
Sentence (law)|Prison Sentence
Sergeant major|Command Sergeant Major
Sergeant|Sgt. 1st Class|Police Sergeant
Service (motor vehicle)|Car Maintenance
Service à la française|French dining
Service animal|Service Animals
Service dog|Service Dogs|Service Dog|service dogs
Service flag|Gold Star
Sesame|Benne
Set-in neck|Set In
Seventh grade|7th Grader
Seventh-inning stretch|Seventh-inning|seventh inning
Severe weather terminology (United States)|Frost Advisory|Lakeshore Flood Warning|frost advisory|Dense Fog Advisory|Frost Advisories
Severe weather|Severe Weather|Severe
Sewage treatment|Wastewater Treatment Plant
Sex in film|Sex Scene
Sex life|Sex Life|sex life
Sex offender registry|Sex Offender Registration|Sex Offender Registry|Registered Sex Offender|registered sex offender
Sex offender|Sex Offender
Sexism|Gender-Bias|Sex Discrimination|Sexual Discrimination
Sexless marriage|Sexless Marriage
Sexual abuse|sexual abuse|Sexually Abusing|Sexually Abused|Sex Abuse
Sexual assault|Sexual Assault|sexually assaulting|sexual assault|Sexually Assault|Sexually Assaulting
Sexual attraction|Sexiest
Sexual dysfunction|Sexual Disorder
Sexual harassment|sexual harassment|Sexual Harassment
Sexual intercourse|Having Sex
Sexual misconduct|Sexual Misconduct
Sexualization|Hyper-Sexualized
Sexually transmitted infection|Sexually Transmitted Disease|STDs|STD|sexually transmitted diseases|STIs
Shadow|Shadowy
Shag (haircut)|Shag Haircuts
Shame|Shamer
Shapeshifting|Shape-shifting
Share price|stock price
Shareholder|Shareholders
Sharps waste|Needle Disposal|Needle-disposal
Shelby Park, Louisville|Shelby Park
Shelf life|Expiration Dates|best by
Shell (theater)|Band Shell
Shelter in place|Shelter-in-place|Shelter In Place
Shepherd's pie|Shepherd's Pie
Sheriff officer|Sheriff's Officer
Sheriff|Sheriff's Office|Sheriff's Department|sheriff's office|sheriff's deputy|sheriff's department|sheriff|Sheriff's Deputy|Sheriff's department|County Sheriff's Office|County Sheriff|Sheriff's office
Ship breaking|Sold for Scrap
Shirred eggs|Baked Eggs
Shoemaking|shoe repair
Shooting guard|Off Guard|SG
Shooting range|Shooting Range|gun range|Gun Range
Shootout|Police Shootout
Shoplifting|Retail Theft
Shopping mall|Malls|Camp Creek Marketplace|Shopping Center|shopping center|Shopping Malls|Shopping Centre
Shore Road, Belfast|Shore Road
Short (finance)|short sellers
Short circuit|Short-circuiting
Short list|Long List
Short ribs|Short Ribs
Short story collection|Short Story Collection
Shortstop|SS
Shoulder problem|Shoulder Injury
Shower cap|shower cap
Shred guitar|Lightning-fast
Shrimp and prawn as food|Popcorn Shrimp
Shutdown (computing)|Shut Off|Shut-off|shut off|Shutting Down
Siamese cat|Siamese Cat
Side collision|T-boned|T-Boned|t-boned
Side dish|side dishes|Side Dish|Side Dishes
Side platform|Side
Sign language|sign|Sign
Significant weather advisory|Advisory
Sildenafil|Viagra
Silent film|Silent
Silo|grain bin|Grain Bin
Simplicity|Simpler
Singing|Singer
Single (music)|Single
Single-payer healthcare|Medicare For All|Medicare|Medicare-for-all|Medicare for All
Single-sex education|All-female|For Boys
Sinking (metalworking)|Sinking
Sinusitis|Sinus Infection
Sisig
Sister group|Closest Relative
Sixth grade|Sixth Grade
Sixth man|Sixth Man
Skateboarding
Skatepark|skate park|Skate Park
Skiing
Skin tag|Skin Tags
Skipper (butterfly)|Skippers
Skull fracture|fractured skull
Slang|Slang Terms
Slavery|Slavery;
Sleep deprivation|Sleep Deprivation
Sleep disorder|Sleep|sleep problems
Sleep medicine|Sleep Medicine
Sleep|Sleep Pattern
Sleeper hit|Sleeper Hit
Sleepover|Movie Night|Movie Nights
Slip-on shoe|Slip On
Slipway|boat ramp|Boat Ramp|boat launch
Sloppy joe (New Jersey)|Sloppy Joe
Sloppy joe|Sloppy Joes|Sloppy|Sloppy Joe
Slot machine|Gaming Machines|gaming machines|Quick Hits
Slow cooker|Crock Pot|Crockpot|Slow-Cooker|Crock-Pot|Slow Cooker|slow cooker
Slush (beverage)|Slushy
Small business|small businesses|small business|Main St.|Small Business|Small Businesses
Small intestinal bacterial overgrowth|SIBO
Smear campaign|Smear Campaign
Smoke detector|Smoke Detector
Smoked salmon|Cold Smoked Salmon
Smoking (cooking)|Smoked
Smoking cessation|Ways to Quit Smoking
Smouldering|Smoldering
Snack bar|Snack Bar
Snake|Snake Diet
Snap (gridiron football)|Snap Counts
Snatch (weightlifting)|Power Snatch|power snatch
Sniper rifle|Sniper Rifle
Snooker world rankings|Rankings
Snorkeling
Snow cone|Snow Cones
Snow flurry|Snow Flurries|Flurries
Snow in Florida|Snow' in Florida
Snow removal|snow plowing
Snow|Snowfall|snowfall
Snowboarding
Snowclone|Mother of All
Snowmageddon|Snow-mageddon
Snowmaking
Snowplow|Snow Plows
Soba|Soba Noodles
Soccer-specific stadium|Soccer Stadium
Social club|Social Club
Social engagement|Social Engagement
Social exclusion|Inclusivity
Social issue|Social Issues
Social media|Social Media|social|social media|Social|Social-Media
Social science|Social Science
Social security|Social
Social stigma of obesity|fat shaming|Fat Shaming
Social work|social workers
Social-network game|Facebook Game
Socialization|Socializing
Soda fountain|Soda Fountain
Soft drink|Soft Drink
Soft landing (economics)|Soft Landing|soft landing
Softail
Software release life cycle|Releases
Software|Computer - Software
Soil contamination|Contaminated
Solar energy|Solar
Solar power|Solar
Solar telescope|Solar Telescope
Solar transit|Solar Transit
Soldier|Solider
Solid|Solidly
Solid-state drive|SSD|SSDs
Something (Beatles song)|Something™
Soulmate|Soul Mate|soul mate
Soundtrack|movie soundtracks|Movie Soundtracks
Source (journalism)|Deep Background
Sous-vide|Sous Vide|sous vide
South End, Seattle|South Seattle
Sovereign wealth fund|Wealth Fund|wealth fund
Soy milk|Soy Milk
Space exploration|Space Exploration|space exploration
Space force|Space Force
Space marine|Marine
Space station|Space Station|space station
Space suit|Spacesuit
Speaker (politics)|presidents
Special Relationship
Special adviser (UK)|Special Advisor
Special agent|Special Agent in Charge
Special edition|Limited-edition
Special education|Special Education|EC
Special operations|Spec Ops|Special Operations
Special prosecutor|Special Prosecutor
Special road|Special Road
Specialist (rank)|Spc
Speech balloon|Z
Speech|Speaking
Speed bump|Speed Humps|speed humps
Speed wobble|Death Wobble
Sphere of influence|Influential
Spice mix|Seasoning Mixes
Spice rub|Dry Rubs
Spider bite|SPIDER BITE
Spider web|Spider Web
Spina bifida|Spina Bifida
Spinach salad|Spinach Salad
Spinal cord injury|spinal injury|Spinal Injury|Spinal Cord Injury
Split infinitive|Not To|To Not
Splitting (psychology)|Splitting|splitting
Spore print|In Mass
Sport bike|Sportbike
Sport management|Sports Business|Sports business|sports business
Sport utility vehicle|Luxury SUV|SUVs|SUV|Luxury SUVs|Utility Vehicle|4x4
Sports analyst|Studio Analyst
Sports car|sports car|Sports Cars|Sports Car
Sports club|Sports Club
Sports equipment|sporting goods
Sports game|Golf Game
Sports governing body|International Federations
Sports journalism|Sports Editor|Sports Columnist
Sports league|Sports League
Sports rating system|Power Rankings|power rankings|POWER RANKINGS
Sports sedan|sport sedan|sports sedan|Sports Sedan|Sport Sedan
Spot market|Cash Market
Spotted owl|Spotted Owl
Spray painting|Spray Painted|Spray-painted|Spray-Painted
Spread betting|Point Spreads
Stag and doe|Stag & Doe
Stage (theatre)|Off Stage|off stage
Stage combat|SAFD
Stage lighting accessories|Barn Doors
Staged crash|Staged Crash
Stain|Coffee Stains
Stand-up comedy|Stand-up|Comedy Show
Stand-your-ground law|Stand Your Ground
Standing desk|standing desk
Standing rib roast|Prime Rib
Standing-room only|Standing-room
Star formation|New Stars
Starting lineup|starting lineup|The Starting|Starting
Starting pitcher|Starting Pitchers
Startup accelerator|Startup Accelerator
Startup company|Startup
Starvation response|starvation mode|Starvation Mode
State court (United States)|municipal court
State dinner|State Dinner
State highway|State Route|State Road
State law (United States)|State law
State of emergency|National Disaster
State of matter|States of Matter
State of the art|State-of-the-art
State park|state parks|State Parks
State police (United States)|State Troopers|State police|State Police|state police
State school|Public Instruction|Schools|public schools|Public|Public School District|Public High Schools|Public-school|School|Governmental|State|Public Schools|state
State supreme court|State Supreme Court
State visit|official visit|visit|Official Visit|royal tour|Visit
State's attorney|The State's Attorney|State Attorney's Office
Statistics
Status message (instant messaging)|Status
Statute of limitations|Statute Of Limitations
Steak sandwich|Steak Sandwiches|Steak Sandwich
Steam locomotive|steam locomotive
Steel fence post|T-post
Steel mill|Steel Works
Stepfamily|Step-Parent
Stew|The Stew
Stiff-arm fend|Fend Off
Stimulant psychosis|AP
Stock (food)|Fond
Stock market|Stock-market|Market|stock market|Stock Market
Stock valuation|stock valuation|Stock Valuation
Stock|Stocks
Stolen base|SB|Steal|Steal A Base
Storage tank|Storage Tank
Storey|The Story|second floor|Second Floor
Storm surge|Storm Surge
Storm warning|Storm Warning|Weather Warnings
Storm|Wind Storm|Storm System
Storytelling
Stout|Milk Stout
Straight pride|Straight Pride Parade
Strained yogurt|Greek yogurt
Strategic planning|Strategic Planning
Strawweight (MMA)|strawweight|Strawweight
Streaming media|Live Stream|Live Streamed|Livestreamed|Streaming Service|Streaming|Stream|LIVE STREAM|Streaming services|Online Streaming|online stream
Street food|Street Food
Street light|Light Poles
Street racing|street racing|Street-racing
Strength training|Strength Training|strength training|strength
Streptococcal pharyngitis|strep throat
Strike action|Sickout|on strike|Workers Strike|Work Stoppage|Striking|The Work Stoppage
Strikebreaker|Scab
Strikeout|Ks.
Strikethrough|Strike Through
String orchestra|String Orchestra
Strip search|Strip-search
Strip steak|New York strip steak|New York strip
Striped bass|striped bass|Striped Bass
Stromboli (food)|Stromboli
Strong and weak typing|Strongly
Structural engineering|Structural
Structure fire|Structure Fire|house fire|Fire|structure fire|House fire|House Fire
Student athlete|student athletes|Student Athletes|Student-athletes
Student debt|student loan debt|Student Debt|Student Loan Debt
Student government president|Student Body President
Student group|student group
Student loan|Student Loans|student loan|student loans
Student publication|Student Newspaper
Student|College Students|College Student|college students|Students
Students' union|Student Union|Student Government Association|Student Senate|Student Government
Studio|Art Studio
Stuffed squash|Stuffed Zucchini
Stuffing|Filling
Stutthof concentration camp|Stutthof
Subdivisions of Zürich|District 1
Submarine|submariners|Submariners
Subprime lending|Subprime
Subprime mortgage crisis|subprime mortgages
Subscription business model|Subscription Model|subscriptions|Subscriptions
Substance abuse|substance abuse
Substitute (association football)|in place|In Place
Subtropical cyclone|Subtropical
Suburb|Suburbs
Sudden infant death syndrome|SIDS
Sudoku
Suffering
Sugar cookie|Sugar Cookies
Sugar|Sugar.
Suicide|Killed Himself
Sun Valley, Denver|Sun Valley
Sunday roast|Sunday Roast
Sunday school|Sunday School
Sundowner winds|Sundowner
Supercouple|Celebrity Couples|Power Couples
Superintendent (education)|Superintendent of School|School Superintendents
Superintendent (police)|Supt|Police Superintendent|Superintendent of Police|police Superintendent
Superior court|Superior Court
Supermajority|Two-thirds
Supermassive black hole|Supermassive|Supermassive Black Holes
Supermoto|Motard
Superwoman (sociology)|Super Mom
Supper club|Supper Club
Supplemental jurisdiction|Supplemental
Supreme court|COURT
Surf and turf|Surf & Turf
Surfing|Surfer|Surfers
Surgery|Emergency Surgery
Surprise (emotion)|Surprisingly
Surround sound|3D|Spatial Audio
Survey (archaeology)|Archaeological Survey
Survival kit|Survival Kits
Suspicious death|Suspicious Death
Sustainable energy|Clean Energy
Sustainable fishery|Marine Resources
Sweater vest|sweater vest|Sweater Vest
Sweater|Sweaters
Sweepstake|NO PURCHASE NECESSARY|Sweepstakes
Sweet potato pie|Sweet Potato Pie
Sweet potato salad|sweet potato salad
Sweet potato|Sweet Potato|sweet potato|Sweet Potatoes|sweet potatoes
Sweet roll|Sweet Rolls
Swimming (sport)|Swimming and Diving|Swim
Swimming pool|Rooftop Pool
Swing (jazz performance style)|Straight Rhythm
Swing ride|swing ride
Swinging (sexual practice)|Swinging
Synthetic oil|Synthetic Oil|synthetic oil
Syrian Civil War|Syrian conflict|Syrian Conflict|Syria conflict
T-shirt|T-Shirt
Taberna
Table for One
Tabloid journalism|British tabloid
Tackle (football move)|Tackling|rugby tackle|Rugby Tackle
Tackle (gridiron football position)|LT|OL|OT|Offensive Tackles|Lt.|Offensive|left tackle|offensive|Left Tackle
Tai chi|Tai-Chi
Taiwanese fried chicken|Taiwanese Fried Chicken
Takeover|Takeover Offer
Talk radio|TALK|Talk
Talking point|Talking Points
Tantrum|Temper Tantrum
Tap water|City Water
Tardigrade|Water Bears|water bears
Tater tots|tater tot
Taverna
Tax break|Tax Break|Tax Breaks|tax breaks
Tax credit|tax credit
Tax deduction|tax benefits|Tax Deductions
Tax evasion|Tax Fraud|Tax Evasion
Tax lien|Tax Liens|tax liens
Tax noncompliance|Tax Scams
Tax return (United States)|Tax Returns|Tax Return
Tax
Taxable income|taxable income|Taxable Income
Tea leaf grading|Fannings
Teachable moment|Teachable Moment
Teacher|Educators|Teachers|Teaches
Teahouse|tea room|Tea House|Tea Room
Team leader|team leader|Team Leader|TEAM LEADERS
Technical rescue|Technical rescue team
Teh|TEH
Telephone call|Phone Call
Telephone number|Phone Number
Telephone tapping|Wire Taps
Television channel|Ch.
Television film|Made-For-TV Movies|made-for-TV movies
Television network|TV Networks|TV Network|TV networks
Television show|Show|TV shows|TV Show|Shows|TV Shows|TV series
Television|TV|TVs
Temperature|hottest|Hottest|HOTTEST
Temporary work|Gig Economy|Seasonal Jobs
Ten Commandments
Tennessee–Vanderbilt football rivalry|Vanderbilt
Tennis|GIRLS TENNIS|Girls' Tennis|Tennis Player|girls tennis|Girls Tennis
Tent city|Homeless Camp|Homeless Encampment|Tent City|homeless encampment|Homeless Encampments
Terminal illness|Terminally Ill
Terp
Terrace garden|Garden Terrace
Terraced house|Rowhome|row homes|Row Homes
Terrestrial planet|Earth-like
Terrestrial television|Over-the-air
Terrorism|Terrorist group|Terror Attack
Test kitchen|The Test Kitchen|Test Kitchen
Tetrahydrocannabinol|THC-infused|THC
Texas toast
Text messaging|Text|Text Messages|Texts
Thai basil
Thai curry
That|that
The (Cyrillic)|the
The Apprentice Builders|Apprentice
The Thumb|Thumb|Blue Water Area
The arts|The Arts
Theatre of France|French actress
Theatre|Children's Theatre
Thelazia
Theme music|TV Theme Songs|Theme Song|TV theme songs
Therapeutic touch|Healing Touch|healing touch
Therapy dog|Therapy Dog|therapy dog|Therapy Dogs
Therapy|Medical Treatments
There Is
Thermal design power|TDP
These Things
Think tank|Thinktank|Policy Institute
Third Ward, Houston|Third Ward
Third Way
Third baseman|3rd Base|Third Base|Third-base|third base|3B
Third grade|Third-grader
Third year|Third-year
This Man (song)|This Man
This Week (magazine)|This Week|this week
Thought|Thoughtful
Threat|Threatening
Three stars (ice hockey)|Star of the Game|Three Stars
Three-peat|third straight|Third Straight
Three-point field goal|3-Pointer
Three-star rank|Three-star
Three-wheeler|Reverse Trike
Thrombus|blood clot|Blood Clot
Throttle|Throttle Bodies
Thundersnow
Thunderstorm|Severe Thunderstorms|Thunderstorms|Storms|Thundershowers
Thursday|Thorsday
Tick-borne disease|Tick-borne|Tick-Borne Illness
Tie (draw)|Tied
Tiger bread|Dutch Crunch
Tight end|Tight Ends|Tight|tight|TE
Tiki bar|Tiki Bar
Tiki culture|Tiki-themed
Time in Florida|Florida Time
Time management|to do|To Do|to-do list|To-Do List
Time on|Time On
Tiny house movement|Tiny Homes|tiny houses|tiny homes|tiny house
Tire code|Tire Size
Title (property)|Property Owners
To be announced|TBA|TBD
Toaster pastry|Toaster Pastries
Tobacco products|Tobacco Products
Tobacconist|Smoke Shop
Toboggan|Toboggan Run
Toddler|Two-year-old
Toilet paper|toilet paper|TOILET ROLL|Toilet Roll
Toilet roll holder|Toilet Paper Holder
Tom yum|Tom Yum
Tomahawk|Tomahawks
Tomato sauce|Spaghetti Sauce|Tomato Sauce|Pasta Sauce
Tonic water|Tonic Water
Tooth loss|Lost Tooth|lost tooth
Topographic prominence|Prominent
Torc|TORQ
Tornado intensity|Tornado Damage|Damage
Tornado outbreak|Tornado Outbreak
Tornado warning|tornado warning|Tornado Warning
Tottenville, Staten Island|Tottenville
Touchdown celebration|Touchdown Celebration
Touchdown|Rushing TDs|TDs|TD|TD.
Touring car racing|Touring Car Racing
Tourism|Tourists|Vacation|Tourist|International Travel
Tourist attraction|Attractions|Tourist Destinations|travel destinations|Tourist Attraction|Travel Destinations
Tournament|KO'd
Town (New Jersey)|New Jersey town
Town council|Village council|Town|Town Council|town|town council
Town meeting|Town Meeting|town meeting
Town|Small Towns
Township (United States)|TWP.
Toy drive|Toy Drive|toy drive
Track (rail transport)|Train Tracks|train tracks
Track and field|Indoor|Track
Trade (sports)|Trade Deadline|Deadline|Trading|Traded|trade deadline
Trade|Buying|Trading Company
Traditional medicine|Home Remedies
Traffic collision|Traffic Accident|Car Wreck|Car Smashes|Car Crash|Collision|motorcycle crash|Car Accident|Car Collision|MVA|car crash|Crash|Motorcycle Crash|Vehicle Crash|car crashes|Car Crashes|Vehicle Crashes|Run Over|Vehicle Collision
Traffic congestion|Traffic Jam|Traffic Jams|traffic jams|traffic jam
Traffic enforcement camera|Bus Lane Cameras|Speed Camera|bus lane camera
Traffic engineering (transportation)|Traffic Engineering
Traffic stop|traffic stop|Traffic Stop
Tragedy|Tragic
Trail blazing|Trail Markers
Trail running|Trail Run
Trail|Trails LLC.|equestrian trail|hiking trail
Trailer (promotion)|Film Preview
Trailer park|Park|Mobile Home Park|mobile home park
Train operating company|Train Operators
Train ride|train rides|Train Rides
Train shed|Train Shed
Train station|train station
Train ticket|train tickets
Train wreck|Train Collision
Training camp (National Football League)|Training Camp
Training ground (association football)|Training Facility|training facility
Tram|Streetcar
Trans woman|Transgender Women
Transatlantic flight|trans-Atlantic
Transfer market|Transfer Market
Transgender youth|Trans Youth
Transgender
Transit bus|Transit Bus
Transit district|transit agency
Transit police|Transit Police
Translation|Spanish|English translations
Transmission tower|transmission tower|Transmission Tower
Transport hub|Transit Center
Trash-talk|Trash Talking
Trauma team|Trauma
Travel agency|Travel Agency|travel agency
Travel warning|Travel Alert
Treadmill desk|Treadmill Desks
Treasure trove|Treasure Trove
Tree farm|Tree Farm
Tree house|Tree House
Tree sitting|tree sit
Tree stand|Deer Stands
Tree|Trees
Treif|Trayf
Tri-tip|Tri-Tip
Trial court|Trial Court Judge
Triathlon|Triathletes
Tribe (Native American)|Tribal|Indian tribes
Trick-or-treating|Trick-or-treat|Trick-or-treaters|trick|Trick or Treating|Trick-Or-Treat|trick-or-treat|trick-or-treating|Trick-Or-Treaters|Trick-or-Treaters|Trunk or Treat|Trick-Or-Treating|Halloween Candy|trunk or treat|Candy|Candy Company|Trick|trick-or-treaters|Trick-or-Treat|Trick-or-Treating|Trunk-or-Treat|Trick or Treat
Trier of fact|Fact Finder
Trigger (firearms)|Double Sets
Trompo
Tropical cyclone scales|TD
Tropical cyclone warnings and watches|TROPICAL STORM WARNING|tropical storm watch|tropical storm warning
Tropical cyclone|tropical depression|Tropical Storm|Tropical|Tropical Depression|Hurricane-like|Tropical Storms|tropical|tropical storm|Tropical Cyclone
Tropical rock|Trop-rock
Tropical savanna climate|Aw
Truck driver|Driver|Truck Driver
Truck stop|truck stop
Truck
Truffle oil|Truffle Oil
Trusted timestamping|TSA
Tuberculosis|TB
Tumors of the hematopoietic and lymphoid tissues|Blood Cancer
Turkey (bird)|Turkey Like
Turkey fryer|Deep Fried Turkey
Turkey trot|Turkey Trots
Turn-based tactics|TBT
Turnout (ballet)|Turn In
Turtle|Pet Turtles
Twin|Identical
Twinkie|Twinkies
Twist (dance)|The Twist
Two-round system|Runoff
Two-way contract|Two-Way Deal|Two-way-contract
Txakoli|Txakolina
Types of motorcycles|Concept Bike|Dirt Bikes
Types of volcanic eruptions|Volcano Eruption
U
Ulama|Muslim cleric
Unanimity|Unanimously
Uncompressed video|RAW VIDEO
Unconscionability|Unconscionable
Underway
Unemployment|Jobless|Unemployed
Unidentified flying object|UFOs|UFO
Unit of observation|Data Point
United States Attorney|U.S. attorney|United States attorney|U.S. attorney's office|US attorney|Federal Prosecutor|U.S. Attorney|U.S. Attorney's Office|attorney|U.S. Atty|US Attorney|United States Attorney's Office|United States district attorney|U.S. Attorney's office
Universal quantification|For Every
Unmanned aerial vehicle|Drones|Drone
Unmanned surface vehicle|Autonomous Ship
Unreported employment|Off duty|Off-duty
Unsecured creditor|Unsecured Creditors
Up to|Up To
Upcycling|Creative Reuse
Upside-down cake|Pineapple Upside-Down Cake
Upādāna|Clinging
Urban agriculture|City Farm
Urban area|Urban
Urban planner|City Planner|Planning Board
Urban rail transit|Rail Transit
Urban village|Urban Villages
Urology|Urologist
Use of force|Police Use Of Force|use of force
User (computing)|Users
Uterus transplantation|Uterus Transplant|Uterus Transplants
Utility pole|Power Pole
Uttering|Uttering and Publishing
Vaccination policy|Mandatory Vaccination
Vacuum cleaner|Vacuum Cleaner|vacuum cleaner
Value added|Add Value
Value investing|Value Stocks|Value
Value menu|dollar menu|Dollar Menu
Value-based pricing|Value-priced
Van|Passenger Van|van.
Variable valve timing|Variable Valve Timing
Vast right-wing conspiracy|Right-Wing Conspiracies
Veganism|Vegans
Vegetable|Veggie
Vegetarian cuisine|Vegetarian Recipes
Vegetarianism|Vegetarian|Vegetarian Diet|vegetarian diet|vegetarian
Veggie burger|veggie burger|Vegan Burgers
Vehicle fire|car fire|vehicle fire|Vehicle Fire|Car fire|Car Fires
Vehicle insurance|Car Insurance
Vehicle|Moving Vehicle
Vehicular homicide|vehicular homicide
Vending machine|Vending Machine|vending machine
Venture capital|venture capital
Venture round|Series C|Series B|Series D
Vested interest (communication theory)|Vested Interest
Veteran|military veterans|Veterans Services|War Vets|Military Veterans|Veterans
Veterinary medicine|Veterinary Clinic|Veterinary Hospital
Veðrfölnir and eagle|Unnamed Eagles
Via (electronics)|VIA|Via
Vice president|Division Vice-President|Senior VP
Vice|Vice Unit
Vickery Meadow, Dallas|Vickery Meadow
Victimology|Crime Victim Services
Victory parade|victory parade|Victory Parade
Video camera|Video
Video capture|Video Captures
Video game content rating system|Everyone
Video game remake|Enhanced|enhanced
Video game|the video game|Video Games
Video on demand|SVOD|On-demand
View (Buddhism)|View
Vigil|prayer vigils|Prayer Vigils
Vigili del Fuoco
Village council (Palestinian Authority)|Village Council
Village|Village Center
Villain|Movie Villains
Vintage clothing|Vintage Look
Violence|Violent
Viral video|Viral Video|Viral Videos|Viral|viral|Viral Moment
Virginia Village, Denver|Virginia Village
Virginia school of political economy|Virginia school|Virginia Schools
Virtual channel|Virtual|virtual
Virtual machine|virtual machine|VMs
Virtual reality|VR|Virtual|Virtual Reality
Virus|Viral
Visiting judge|Visiting Judge
Visitor center|visitor center|Visitor Center|welcome center|Visitors Center
Visual impairment|Blindness
Vitamin deficiency|Vitamin Deficiencies|vitamin deficiencies
Vocal rest|Vocal Rest
Vocational education|Career and Technical Education|Career and Technical
Vocational school|Vocational
Volleyball|GIRLS VOLLEYBALL|High School Volleyball|girls volleyball
Volunteer fire department|Volunteer fire|Volunteer Fire Department|Volunteer Fire
Vote early and vote often|Early and Often
Voting machine|voting machines
Voting|Poll|VOTE|I Voted|Vote
WHOIS|Who Is
Walk-off home run|walk-off home run
Walkaround (boat)|Walkaround
Walker (Star Wars)|At St
Walkout|Walk Out|Walk
Want|Wants Service
Wanted poster|wanted posters|Wanted Posters
War memorial|War Memorial
Wardrobe stylist|Celebrity stylist|Celebrity Stylist
Warming center|warming center
Warning sign|Warning Signs
Washington Referendum 74|Referendum
Washington court system|Seattle District Court
Waste collector|sanitation worker|Sanitation Worker
Waste management|Waste Management
Wastewater|Wastewater Treatment Facility
Water buffalo|water buffalo|Buffalos
Water park|Water Park
Water slide|water slide|Water Slide
Water supply network|Water Main|Water-main|water main|Water Services
Water taxi|Water Taxi
Water tower|water tower
Water treatment|Water Treatment Plant
Water|H2O
Waterline length|W/L
Watershed management|Watershed Management
Watt|KW|MW
Wazwan
We Could
Wealth management|wealth management|Wealth Management
Wealth|global wealth|Global Wealth
Weather forecasting|Forecast|Weather Forecast|Forecasters|Weather Outlook|Forecasting|forecasters|weather forecast|Weather|Weather forecast.
Weather radar|Weather|Radar
Weather radio|WEATHER ALERTS|Weather Alerts
Weather|weather conditions|Inclement Weather|Weather Conditions
Weather-related cancellation|SCHOOL CLOSINGS
Web hosting service|web hosting|Web Hosting
Web search engine|Search|SEE|People Search
Webcam model|Camgirl
Wedding dress|Wedding Gowns|Wedding Dresses
Wedding photography|wedding photography|The Wedding Photography|Wedding Photo
Wedding reception|Wedding Dances
Wedding soup|Italian wedding soup
Wedding vow renewal ceremony|Second Wedding
Wednesday
Weight class (boxing)|weigh in|Weigh In
Weight gain|Gain Weight|Gaining Weight|gain weight
Weight loss|Losing Weight|weight loss|Weight-Loss|losing weight|Weight|Weight Loss|Lose Weight|lose weight
Weight training|Lifting Weights
Weight|Weigh
Welfare|Public Assistance|Benefits
Wellness (alternative medicine)|Health and Wellness
West Colfax, Denver|West Colfax
West Kensington, Philadelphia|West Kensington
Westerleigh, Staten Island|Westerleigh
Western riding|Performance Horses
Whale shark|Whale Sharks
Whale watching|Whale Watch
Wheat tortilla|Flour Tortilla
While loop|While
White chocolate|White Chocolate
White nationalism|White Nationalist
White privilege|white privilege|White Privilege
White supremacy|White Supremacist|white supremacist
White-collar worker|White-collar|Office Workers
White-tailed deer|White-tailed|white-tailed
Who (pronoun)|Whose
Whodunit|Whodunnit
Whole life insurance|Whole Life
Wholesaling|Wholesale
Whooping cough|Whooping Cough|Pertussis|pertussis|whooping cough
Wicker Park, Chicago|Wicker Park
Wide receiver|Slot Receivers|WR.|Wideout|Wide Receiver|WRS|AP|WR|Receiver|receiver|WRs|wide receiver
Wild boar|Wild Boar|wild boars|wild boar|Wild Boars
Wild card (sports)|Wild Card Round|Wild Card
Wild rice|wild rice
Wild turkey|wild turkeys|Wild Turkeys|Wild Turkey
Wildfire suppression|Fire Crews|Fire crews
Wildfire|Brush fire|Vegetation fire|Rural Fire Service|Grass Fire|grass fire|Fires|Brush Fire|Vegetation Fire|Bushfire|brush fire|Grass fire
Wimpey no-fines house|No Fines
Win-win game|win-win
Wind advisory|WIND ADVISORY|Wind Advisory|wind advisory
Wind farm|Wind Farm|wind farm
Wind speed|Wind Speeds
Wind turbine|Wind Turbines|wind turbines
Window cleaner|Window Washers|window washers
Windscreen wiper|windshield wiper|Windshield Wiper
Wine bar|wine bar|WINE BAR|Wine Bar
Wine cellar|Wine Cellar|wine cellar
Wine cocktail|Wine Cocktail
Winemaking
Winning streak (sports)|Longest Winning Streak
Winter service vehicle|Salt Trucks
Winter squash|Winter Squash
Winter storm watch|Winter Storm Watch
Winter storm|Winter Storm|winter weather|Winter-weather|Snow Storms|Winter Weather
Wireless speaker|wireless speaker
Wish list|Wish List
Witch-hunt|Witch Hunt
Witchcraft|Witches
Woman|Women
Women artists|Female Artists
Women in science|Women in Science
Women in the workforce|Women in the Workplace
Women's college|women's college
Women's health|Women's Health
Women's suffrage|Women's Suffrage|women's suffrage
Woodpecker|Woodpeckers
Work in process|Work-in-progress
Work of art|Art|Work of Art|Works
Workaround|Work Around
Workers' compensation|Worker's Compensation
Workforce|Worker
Working class|Working-class
World energy resources|Energy Resources
World record|Record Time|World-Record
Wrestling
Xenophobia|Xenophobic
Xiaolongbao|Xiao Long Bao
Yana (Buddhism)|Two Vehicles
Year Five|Year 5
Year Three
Year Two|Year 2
Yellowfin tuna|Yellowfin Tuna
Yer|Yers
Yet another|Yet Another
Yinz
Yorker|Yorkers
You Do
You|YOUR
Youth center|Youth Center
Youth engagement|Youth Engagement
Youth ministry|Youth Pastor
Youth system|Youth team|youth football|YOUTH FOOTBALL|Youth Football
Yukon Gold potato|Yukon Golds
Yumi
ZIP Code|Zip Code|Zip Codes
Zebra|The Zebras
Zilker, Austin, Texas|Zilker, Austin|Zilker
Zolpidem|Ambien
Zona pellucida|ZP
