Acton (UK Parliament constituency)|Acton
Advent|advent
All Saints' Day|All Saints Day
Armistice Day
Athens A|Athens a
Belfast North (UK Parliament constituency)|Belfast, North
Black Friday (shopping)|Black|Blitz Day|Black Friday
Boss's Day|National Boss Day
Braintree (UK Parliament constituency)|Braintree
Bristol Central (UK Parliament constituency)|Bristol Central
Chinese New Year
Christmas Eve
Christmas|Christmas Co|Christmas-themed|Holiday|Christmas Spirit|Christmas Day
Columbus Day|COLUMBUS DAY|Columbus day|Columbus Day Parade
Dartmouth (UK Parliament constituency)|Dartmouth
Day of the Dead|Dia De Los Muertos|Dia de los Muertos|Día De Los Muertos|Día de los Muertos
Diwali|Festival of Lights|festival of lights|Hindu festival of lights
East Norfolk (UK Parliament constituency)|Norfolk's East
Easter
Education and Sharing Day|Education Day
Groundhog Day|Groundhog's Day
Guy Fawkes Night|Bonfire Night
Halloween|Halloween-themed|Halloweens|Malloween|The Halloween|All Hallows Eve|All Saints Eve|Halloweeen|All Hallows' Eve|halloween
Hanukkah|Chanukah
Harvest festival|Harvest Festival|harvest festival
International Men's Day|Men's Day
Labor Day|Labor Day Weekend
Lantern Festival
Legal (constituency)|Legal
Martin Luther King Jr. Day|Martin Luther King, Jr. Day
May Day
Memorial Day|Memorial Day Weekend|Memorial
Mother's Day
National Doughnut Day
New Year's Day|New Years Day
Remembrance Day|Remembrance Day Service
Remembrance Sunday|Remembrance Week
Rosh Hashanah
Saint Patrick's Day|St. Patrick's Day|Day
Saturday of Souls|Memorial Saturday
Shabbat|Shabbat services
Sweetest Day
Tax Day|Tax season
Thanksgiving (Canada)|Canadian|Turkey Day
Thanksgiving (United States)|Thanksgiving|American Thanksgiving|Thanksgiving Day
Valentine's Day|Valentine's
Veterans Day|Veterans Day Parade|Armistice Day|Veterans Inc.|Veteran's Day|veterans|VETERANS DAY|Veterans|VETERAN'S DAY
Victory Day (9 May)|Victory Day
Wareham (UK Parliament constituency)|Wareham
World Mental Health Day
Yom Kippur|Jewish Day of Atonement
